종목코드,종목명,시작일,기준가,종료일,종가대비등락률,거래량,거래대금
"060310","3S","2095","3195","1100","52.51","370482909","1079026399767"
"054620","APS","15750","6940","-8810","-55.94","35799120","393770489630"
"265520","AP�ý���","18350","23300","4950","26.98","25315928","529638486510"
"211270","AP����","10050","14250","4200","41.79","224904295","4087267514980"
"126600","BGF���ڸ�Ƽ������","4567","4465","-102","-2.23","120610043","835127898555"
"013720","CBI","4080","1993","-2087","-51.15","744705695","388818694015"
"083790","CG�ι�����","3500","2990","-510","-14.57","91242010","361296026975"
"035760","CJ ENM","104700","71200","-33500","-32.00","26390503","2086873947050"
"311690","CJ ���̿����̾�","25483","17500","-7983","-31.33","9038390","261031400830"
"051500","CJ�����ÿ���","32000","24300","-7700","-24.06","10363330","300467541740"
"058820","CMG����","2150","2445","295","13.72","203639437","475091954766"
"023460","CNH","2800","1838","-962","-34.36","3084373","6780451492"
"056730","CNT85","3300","1407","-1893","-57.36","91359338","152378518723"
"065770","CS","1500","1355","-145","-9.67","14086502","21208116372"
"083660","CSA �ڽ���","980","1367","387","39.49","55066977","73303068304"
"404950","DB��������10ȣ","2607","3150","543","20.83","24547111","74076725155"
"060900","DGP","6400","1724","-4676","-73.06","300407751","473246674733"
"025440","DH�������","3000","2200","-800","-26.67","26396944","39112765673"
"068790","DMS","5980","6920","940","15.72","25093817","159936747105"
"241520","DSC�κ���Ʈ��Ʈ","3395","3150","-245","-7.22","70231507","291765651890"
"065150","DSEN","425","273","-152","-35.76","308128811","149916954335"
"180400","DXVX","8100","6110","-1990","-24.57","77079396","546937253235"
"245620","EDGC","1718","426","-1292","-75.20","502829600","725618515340"
"037370","EG","7400","12710","5310","71.76","188055628","3562914765940"
"050120","ESť��","4250","2950","-1300","-30.59","11350265","49708414810"
"214270","FSN","3240","2730","-510","-15.74","370913313","1379114377846"
"130500","GH�ż���","4080","2930","-1150","-28.19","18699236","64850332085"
"900290","GRT","2400","3200","800","33.33","108810721","403883211220"
"083450","GST","19600","27750","8150","41.58","22381714","583126999200"
"297890","HB�ַ��","3039","5420","2381","78.35","298581018","1960288926055"
"078150","HB��ũ���","1920","2425","505","26.30","749087882","2134030770091"
"195940","HK�̳뿣","37050","44500","7450","20.11","53312012","2005069034450"
"028300","HLB","27088","53200","26112","96.40","290920930","10347099605550"
"278650","HLB���̿�����","4650","3135","-1515","-32.58","401769371","1713684710595"
"067630","HLB��������","10600","11440","840","7.92","157184016","1672246843790"
"024850","HLB�̳뺣�̼�","948","3130","2182","230.17","415134160","1428694548206"
"047920","HLB����","10600","15360","4760","44.91","99997441","1394439718690"
"115450","HLB�׶�ǻƽ��","5437","4355","-1082","-19.90","93636119","583557269805"
"046210","HLB�ĳ���","4240","4225","-15","-0.35","107684774","526992808205"
"403870","HPSP","13375","42900","29525","220.75","435066177","14391620887895"
"036640","HRS","5200","5360","160","3.08","64711940","399214047375"
"426550","IBKS��19ȣ����","2499","2815","316","12.65","17535478","45740311020"
"439730","IBKS��20ȣ����","2045","2335","290","14.18","2667880","6016413735"
"442770","IBKS��21ȣ����","2040","2245","205","10.05","2726856","5973636535"
"095340","ISC","31350","83000","51650","164.75","98814645","6901106454450"
"099520","ITX-AI","1284","1284","0","0.00","0","0"
"950170","JTC","3570","3830","260","7.28","21145551","89108517265"
"067290","JW�ž�","3459","2475","-984","-28.45","46772620","138734606895"
"035900","JYP Ent.","67800","101400","33600","49.56","123428591","12678830255638"
"318000","KBG","5720","8230","2510","43.88","332472123","4222323882340"
"024840","KBI��Ż","1310","1475","165","12.60","252231054","490970758587"
"024120","KB����ý�","3660","4905","1245","34.02","103681472","620976702315"
"021320","KCC�Ǽ�","6770","5010","-1760","-26.00","10226641","60293410595"
"036670","KCI","8890","7200","-1690","-19.01","4290037","37457720970"
"044180","KD","738","705","-33","-4.47","310223271","323287365252"
"151860","KG ETS","9570","11380","1810","18.91","370451249","6084554768700"
"046440","KG�������","5640","5360","-280","-4.96","151862741","1102557717450"
"035600","KG�̴Ͻý�","11700","12180","480","4.10","44878288","565682556320"
"226360","KH �Ǽ�","452","319","-133","-29.42","303166758","132645079807"
"111870","KH ����","3705","2970","-735","-19.84","389557550","102303502047"
"060720","KH����","13900","14590","690","4.96","76428942","1354825271430"
"058400","KNN","889","1167","278","31.27","434689079","484882608770"
"122450","KX","5200","5120","-80","-1.54","13286026","69242055485"
"052900","KX������","1180","1257","77","6.53","57538687","76299730836"
"376190","LB���","6530","6400","-130","-1.99","21245826","173132118720"
"061970","LB������","6590","7890","1300","19.73","82123678","636774966000"
"060370","LS�����ַ��","4940","10810","5870","118.83","86856985","876929430025"
"086960","MDS��ũ","1860","1714","-146","-7.85","3144996836","8686302726964"
"038340","MIT","1283","1283","0","0.00","0","0"
"160550","NEW","8150","4675","-3475","-42.64","77058569","555597899825"
"053290","NE�ɷ�","3770","5200","1430","37.93","344902639","2013198759475"
"060250","NHN KCP","13400","9980","-3420","-25.52","100718453","1134559445870"
"104200","NHN����","5700","4660","-1040","-18.25","76531693","503571876100"
"024940","PNǳ��","8060","8860","800","9.93","65738530","543763774560"
"218410","RFHIC","22450","17990","-4460","-19.87","49763473","1028468904450"
"327260","RF��Ʈ������","12000","11110","-890","-7.42","35730793","481137972380"
"091340","S&K������","3590","2940","-650","-18.11","38786665","169254148070"
"419530","SAMG����","25300","20650","-4650","-18.38","133508642","4444114295134"
"019550","SBI�κ���Ʈ��Ʈ","1065","876","-189","-17.75","235954039","233582787536"
"950110","SBI����ũ�ַ����","3900","4565","665","17.05","4480846","22111952605"
"151910","SBW��������","799","386","-413","-51.69","200471784","132808525568"
"036120","SCI������","3960","3560","-400","-10.10","309407208","1321542450235"
"099220","SDN","1715","1305","-410","-23.91","244534428","477980792304"
"036540","SFA�ݵ�ü","3845","6230","2385","62.03","765719141","4288391017855"
"255220","SG","1175","1700","525","44.68","222949225","360494424680"
"040610","SG&G","1595","1602","7","0.44","52338242","97220385506"
"049470","SGA","771","582","-189","-24.51","124696636","110860316511"
"184230","SGA�ַ����","783","777","-6","-0.77","146030895","142763655779"
"016250","SGC����ũ�Ǽ�","28500","19090","-9410","-33.02","1654331","37536182240"
"048550","SM C&C","2960","1914","-1046","-35.34","545588381","2348644718168"
"063440","SM Life Design","2250","1956","-294","-13.07","472426518","1397719182695"
"289080","SV�κ���Ʈ��Ʈ","1905","2120","215","11.29","218474441","502532472537"
"089230","THE E&M","315","212","-103","-32.70","681809104","177182166439"
"161570","THE MIDONG","1055","366","-689","-65.31","211264261","264859833120"
"032540","TJ�̵��","6200","6150","-50","-0.81","22335093","152929202660"
"022220","TKG�ְ�","1345","1187","-158","-11.75","35533045","49512651724"
"048770","TPC","3235","3270","35","1.08","210447335","956496668670"
"246690","TS�κ���Ʈ��Ʈ","1655","1408","-247","-14.92","95785585","183242582393"
"317240","TSƮ������","649","492","-157","-24.19","601468694","626582564334"
"057030","YBM��","3360","5340","1980","58.93","155042028","750160605075"
"040300","YTN","5580","6070","490","8.78","264534819","2140696719310"
"051390","YW","3300","3795","495","15.00","6917526","26270725850"
"052220","iMBC","3220","3165","-55","-1.71","165002595","642635678400"
"079940","�����","10150","16900","6750","66.50","20034199","269798173690"
"078890","���±׷�","7532","5090","-2442","-32.42","134681356","1049455522865"
"399720","����Ĩ��","14200","59300","45100","317.61","214342276","7795854035100"
"036620","�������۷��̼�","1870","3050","1180","63.10","337580487","1204360584428"
"217730","�����۹��̿���","2638","2510","-128","-4.85","94442801","209809930471"
"114190","����������","8800","17700","8900","101.14","294419820","6765787433570"
"094480","�����þƸӴ�Ʈ��","4150","11900","7750","186.75","567475404","4588001745280"
"039240","�泲��ƿ","2915","3125","210","7.20","54513880","179827949710"
"053950","�泲����","2680","1677","-1003","-37.43","611935409","1297305629690"
"011040","�浿����","7870","6670","-1200","-15.25","39905042","292772850140"
"024910","��â���","1995","2445","450","22.56","105356564","349608261036"
"198440","�����ø�Ʈ","2380","1712","-668","-28.07","71095178","178912757350"
"049720","�����ſ�����","10800","9640","-1160","-10.74","46273974","482993023000"
"014570","��������","7830","7290","-540","-6.90","11736903","83193394690"
"348150","�����̿���","11050","11060","10","0.09","73912771","1085378901710"
"950190","����Ʈ��Ʃ���","12550","11190","-1360","-10.84","7436388","87969578330"
"098460","����","12750","17370","4620","36.24","238267228","3558421844606"
"035290","���ؿ���","5380","657","-4723","-87.79","404914008","826845308737"
"900280","��缾��","364","178","-186","-51.10","1659743587","457398960682"
"215000","������","112800","88300","-24500","-21.72","9335550","1048522975200"
"121440","����������Ȧ����","4600","3770","-830","-18.04","20238452","94509297660"
"366030","�������","11900","6220","-5680","-47.73","124314040","1244304530450"
"014200","����","1005","1006","1","0.10","135103667","156868867635"
"029480","����","3319","2160","-1159","-34.92","370639804","1579230042736"
"026910","�����Ǿ�","4830","3900","-930","-19.25","5694756","25804538925"
"397880","����11ȣ����","1945","2930","985","50.64","12139836","30160235565"
"421800","����12ȣ����","2025","2095","70","3.46","4541205","9661356640"
"440790","����13ȣ����","1995","2125","130","6.52","5439866","11892181335"
"053270","������ũ","2230","2965","735","32.96","221507606","741740101115"
"066620","����������","16300","14270","-2030","-12.45","4265643","70561272720"
"043650","������","6720","5980","-740","-11.01","27499812","170407035130"
"006050","�������ؿ�","1490","1416","-74","-4.97","45419251","67466320448"
"060480","���Ͻŵ�","2525","2545","20","0.79","136997469","517931310605"
"078130","��������","2220","800","-1420","-63.96","257285583","345325773102"
"307750","������ǰ","6620","6390","-230","-3.47","160558882","1092947636200"
"035080","�׷����Ʈ","14950","13880","-1070","-7.16","37119767","637889141000"
"204020","�׸�Ƽ","2990","3125","135","4.52","25420707","82662749245"
"114450","�׸���������","4448","2270","-2178","-48.97","65651172","320833777021"
"186230","�׸��÷���","10300","8620","-1680","-16.31","45172630","453530316420"
"900070","�۷ι�������","710","565","-145","-20.42","101788293","81791703415"
"204620","�۷ι��ؽ�����","3060","5050","1990","65.03","388297949","1851314498362"
"019660","�۷κ�","1785","1009","-776","-43.47","81295145","146002444637"
"053260","�ݰ�ö��","6300","5310","-990","-15.71","51760997","365361214830"
"036190","��ȭ�ǿ�����","28750","26050","-2700","-9.39","962118","27407595850"
"049080","�Ⱑ����","1400","1224","-176","-12.57","1125568248","1991749917374"
"035460","����ڷ���","2910","2600","-310","-10.65","88030481","278876775945"
"308100","��ڹ���","5530","4830","-700","-12.66","72363592","601348211005"
"187790","����","1030","1377","347","33.69","304644008","451708976104"
"286750","����긯","1325","3150","1825","137.74","277872454","751908449297"
"121600","����ż���","77500","118900","41400","53.42","85383853","12176814187820"
"247660","���뾾������","18900","14260","-4640","-24.55","31631112","600448127180"
"039860","���뿣��","5950","3795","-2155","-36.22","123866301","701680067115"
"091970","����ķ��","1406","1074","-332","-23.61","73086736","74599131586"
"051490","���󿥾ص�","5980","6360","380","6.35","50238877","395308274930"
"137080","����������","7140","6340","-800","-11.20","78690439","813539556630"
"190510","������","17200","14600","-2600","-15.12","104859177","1742968443430"
"242040","�������","1990","2380","390","19.60","992220945","2945864778194"
"089600","�����̵��","25000","22700","-2300","-9.20","17408266","388783954010"
"293580","����IB","1280","1138","-142","-11.09","252645167","447274780462"
"138610","���̺�","18950","21850","2900","15.30","42543610","854367517650"
"130580","���̽���غ�","7700","6280","-1420","-18.44","4226423","31083159420"
"036800","���̽��������","26550","21300","-5250","-19.77","5179372","129625274420"
"267320","������ũ","2920","3390","470","16.10","461356515","1994787849405"
"111710","��ȭ���","8300","6500","-1800","-21.69","4985314","37298092860"
"091590","��ȭ���","10550","7140","-3410","-32.32","48720864","437696279970"
"168330","���򷲿�����","3250","2000","-1250","-38.46","9575427","26012043531"
"094860","�׿�����","567","425","-142","-25.04","339037662","151353134443"
"253590","�׿���","3365","9300","5935","176.37","386956343","2135809959940"
"212560","�׿�����","6600","9320","2720","41.21","110206823","1033992902710"
"095660","�׿�����","36950","26550","-10400","-28.15","77513258","2831033641550"
"042420","�׿�����Ȧ����","24250","25450","1200","4.95","13297758","376879649450"
"950220","�׿��̹���","3995","2110","-1885","-47.18","130559205","341401428411"
"311390","�׿�ũ����","7370","7130","-240","-3.26","37581440","339238416120"
"085910","�׿�Ƽ��","4615","3535","-1080","-23.40","30907279","129433786615"
"092730","�׿���","19200","25150","5950","30.99","13722309","316834890080"
"290660","�׿���Ʈ","1395","1237","-158","-11.33","107205584","170012161727"
"306620","�׿���ũ","3340","2610","-730","-21.86","148842227","502271804130"
"153460","���̺�","7410","7530","120","1.62","5387415","47172324940"
"007390","����ó��","15250","8360","-6890","-45.18","272453983","3016824413480"
"033640","���н�","15650","21900","6250","39.94","71327550","1409474663490"
"330860","���н���ũ","18000","27850","9850","54.72","20856690","516448355170"
"089140","�ؽ��Ϲ��̿�","8478","5590","-2888","-34.06","271201722","1048860756515"
"137940","�ؽ�Ʈ����","572","809","237","41.43","412710396","291044548489"
"396270","�ؽ�ƮĨ","6890","18580","11690","169.67","246286553","3341257302190"
"348210","�ؽ�ƾ","49850","72000","22150","44.43","26701070","1851351933000"
"225570","�ؽ�������","12950","14970","2020","15.60","227436111","4227207162370"
"217270","��ƪ","10500","6930","-3570","-34.00","27752991","271213486040"
"104620","���ǳ��","7520","6640","-880","-11.70","20187586","166554301480"
"194700","��ٷ���","10150","12470","2320","22.86","47814211","534328118450"
"285490","�����","20500","24450","3950","19.27","46789563","1484644811850"
"106520","������غ�","2995","411","-2584","-86.28","254300523","301679599194"
"376930","����","3693","4060","367","9.94","344735174","2139034377845"
"142280","����ڿ�����","5780","4845","-935","-16.18","47686635","238761862705"
"234690","���������","8230","8350","120","1.46","14642160","114006550460"
"065560","�����������","11540","11540","0","0.00","0","0"
"054050","�����̿�","8670","8300","-370","-4.27","14700346","128892682970"
"069140","�����÷�","4145","1947","-2198","-53.03","50097871","193450822906"
"040160","�����÷���","4760","4085","-675","-14.18","51034643","289063285050"
"332290","����","1500","1647","147","9.80","793374709","2083632524292"
"348340","���θ�ī","12450","38200","25750","206.83","355411030","11690334072940"
"060260","������","780","838","58","7.44","75281093","74217534365"
"012340","������","2206","1047","-1159","-52.54","89568134","183547714752"
"214870","�������ĸ�","11450","1383","-10067","-87.92","198724835","931451280431"
"270870","��Ʈ��","11000","7050","-3950","-35.91","7982023","64373281340"
"144960","���Ŀ������","3540","5050","1510","42.66","46823912","266031833400"
"085670","��������","7430","6630","-800","-10.77","170258996","1126213160285"
"064260","�ٳ�","5000","4735","-265","-5.30","403720971","1931125574060"
"340360","�ٺ���ũ","881","2450","1569","178.09","174915241","307600639894"
"039560","�ٻ��Ʈ����","3985","3815","-170","-4.27","232451554","1308861631000"
"154040","�ٻ�ַ翡Ÿ","2440","1888","-552","-22.62","230002573","734299914070"
"032190","�ٿ쵥��Ÿ","30950","13880","-17070","-55.15","152786671","3290413733600"
"068240","�ٿ��ý�","14200","14340","140","0.99","95971387","1483884195410"
"020400","�뵿�ݼ�","8930","13710","4780","53.53","33914249","401795439280"
"008830","�뵿���","6800","11130","4330","63.68","135779888","1443028405650"
"048470","�뵿��ƿ","4025","3990","-35","-0.87","54093284","224897099340"
"004780","�������","4300","4150","-150","-3.49","8552295","38165947490"
"017650","�븲����","8800","8130","-670","-7.61","3585967","32243220040"
"007720","����ҳ����","754","598","-156","-20.69","63117447","45764836943"
"389260","���������","17300","17620","320","1.85","60174735","1481499619870"
"317850","���","13700","9200","-4500","-32.85","166554639","2312030342170"
"290670","�뺸���׳�ƽ","63600","32150","-31450","-49.45","61135450","4057322861650"
"078140","���������","7990","9440","1450","18.15","91133777","1002174847610"
"036480","�뼺�̻���","10300","10890","590","5.73","70439011","1040091257980"
"027830","�뼺â��","2650","1901","-749","-28.26","178193571","381458347657"
"104040","�뼺������","1575","1217","-358","-22.73","91848817","147691072046"
"129920","�뼺������","8440","6550","-1890","-22.39","193136078","2058725165020"
"438220","��Ź뷱����13ȣ����","1860","2275","415","22.31","4090393","9088296540"
"442310","��Ź뷱����14ȣ����","1722","2135","413","23.98","4423010","9654594835"
"020180","����������","1315","1253","-62","-4.71","160985811","194370842630"
"045390","���Ƽ����","3125","3440","315","10.08","310983515","1097360670880"
"108380","����������","12000","11790","-210","-1.75","4847466","58639565500"
"006580","�������","4100","4310","210","5.12","2997257","11297558470"
"007680","���","7020","5180","-1840","-26.21","8429161","63889708900"
"048910","����̵��","13850","12050","-1800","-13.00","40059350","621383668670"
"005710","������","5310","5810","500","9.42","6450767","39447258810"
"290380","����","3680","2300","-1380","-37.50","36382694","105541851080"
"290120","����������","5390","3975","-1415","-26.25","52105560","230618686755"
"120240","����ȭ��","16050","17360","1310","8.16","36216806","689764422930"
"003310","���ֻ��","2110","1707","-403","-19.10","290317896","686842596913"
"078600","�����������","71000","86500","15500","21.83","66377045","6642535817300"
"096350","��â�ַ��","304","447","143","47.04","690677430","377128799185"
"140520","��â��ƿ","2860","2670","-190","-6.64","12043763","34784454325"
"131220","���Ѱ���","6840","6170","-670","-9.80","8725809","60661004900"
"010170","���ѱ����","3315","1376","-1939","-58.49","331151153","744413630669"
"054670","���Ѵ���","8540","9210","670","7.85","29431714","273434444390"
"023910","���Ѿ�ǰ","30600","28000","-2600","-8.50","2022473","56252160700"
"021040","��ȣƯ����","5320","3965","-1355","-25.47","6096271","32125146150"
"021045","��ȣƯ������","9780","8780","-1000","-10.22","175317","1537764530"
"067080","��ȭ����","9400","9470","70","0.74","102944532","1183651508420"
"298540","��������Ȧ����","31950","18050","-13900","-43.51","25293162","625328027450"
"032860","�����","3640","3640","0","0.00","0","0"
"393890","����������","40350","45250","4900","12.14","68277239","3914148664350"
"299170","��������������","1870","2290","420","22.46","69506497","154136959778"
"224060","���ڵ�","9470","6530","-2940","-31.05","25791442","201859006400"
"213420","����׿��轺","39100","45000","5900","15.09","39749259","1721321732700"
"317330","���������Ǿ�","13500","18990","5490","40.67","58348535","1162089647310"
"077360","�������̸�Ż","4790","7670","2880","60.13","214336415","1614849087905"
"090410","�����Ͽ�¡","1880","1992","112","5.96","376671417","887019350464"
"263600","��������","6850","10980","4130","60.29","94773910","988849098780"
"194480","����ý�����","55900","44750","-11150","-19.95","43296679","2225544480600"
"263800","����Ÿ�ַ��","5470","5200","-270","-4.94","219185622","1688593292030"
"206560","������","12700","8920","-3780","-29.76","58480435","632363249530"
"261200","��Ƽ��","8130","9320","1190","14.64","66425837","803658308650"
"067990","����ġ���ͽ�","5680","4880","-800","-14.08","40015856","230127429720"
"006620","�������̿�����","6140","6160","20","0.33","36737445","216491053290"
"100130","����S&C","4565","3120","-1445","-31.65","81978683","368308435670"
"005160","�������","3665","4710","1045","28.51","432400541","2936150681665"
"075970","�����˾ؿ���","3195","3615","420","13.15","344026954","1654053890445"
"086450","��������","16600","16160","-440","-2.65","33914896","518203899389"
"099410","���漱��","2495","2370","-125","-5.01","26562427","77386212975"
"033500","����ȭ����","10850","12090","1240","11.43","61136549","762877163240"
"025950","���ŰǼ�","12550","22450","9900","78.88","66425658","1194543123260"
"088130","���ƿ���","6430","6420","-10","-0.16","23961089","209136424610"
"041930","����ȭ��","8700","8230","-470","-5.40","50965254","500937470970"
"060380","���翡����","1960","2060","100","5.10","47488889","121044037124"
"079960","�����̿���","15000","20550","5550","37.00","27229173","527303939340"
"228340","��������","3070","2485","-585","-19.06","17548308","57962717530"
"088910","�����������̺�","2700","3085","385","14.26","46739091","139649149700"
"094170","����Ƴ���","9890","21500","11610","117.39","256583406","5780023313510"
"013120","��������","3420","3135","-285","-8.33","23234900","77767064080"
"109860","���ϱݼ�","18250","9300","-8950","-49.04","18330658","270030641604"
"032960","���ϱ⿬","12374","12390","16","0.13","16669412","238785446670"
"023790","����ö��","1900","1855","-45","-2.37","50501112","98241239909"
"005290","���������","29950","41450","11500","38.40","199637118","7193218622500"
"025900","��ȭ���","49700","60800","11100","22.33","24362369","1387718998616"
"131970","�λ��׽���","27500","60700","33200","120.73","79254258","3530906249400"
"073190","�����","1925","2510","585","30.39","11942410","28302146352"
"030350","�巡���ö���","742","641","-101","-13.61","415469206","304384205477"
"203650","�帲��ť��Ƽ","2750","3455","705","25.64","430613972","1551789166690"
"223250","�帲�����̿���","2678","3365","687","25.65","46630008","528776345555"
"060570","�帲����۴�","2785","2935","150","5.39","128832584","489458063640"
"217620","����̾ؿ���","1150","505","-645","-56.09","543407026","533231051351"
"016670","����","421","366","-55","-13.06","242190579","122112604871"
"187870","����̽��̿���","13850","15040","1190","8.59","4045864","68516384810"
"066670","���÷�����","4465","6020","1555","34.83","264896104","1937460429860"
"110990","�����Ƽ","5350","18180","12830","239.81","74114383","1121583183960"
"263690","�����","10600","10560","-40","-0.38","6050367","67395774310"
"214680","�����","1385","4320","2935","211.91","1840690280","6526094398443"
"263720","��ؾ��̵��","22600","25600","3000","13.27","29806163","692567091600"
"376300","�����","28800","32400","3600","12.50","82102645","3501251422790"
"141020","�𿡽��ؿ�","3735","22","-3713","-99.41","86951291","10214664366"
"109740","�𿡽�����","5090","5160","70","1.38","18917999","117154430105"
"196490","������ũ�����","3285","3055","-230","-7.00","232974310","1035592469560"
"066900","������","2745","3215","470","17.12","24387719","90571291180"
"127120","�𿣿��̸�ũ","3765","2925","-840","-22.31","22310955","81421849290"
"092070","�𿣿���","13200","24100","10900","82.58","64573704","1295080576210"
"039840","���","19700","23800","4100","20.81","29126185","819555939200"
"219550","����̵�","1240","875","-365","-29.44","956106233","1528342389690"
"310870","����̾�","1540","1708","168","10.91","59540268","117330270367"
"104460","������ǿ�����","40700","24050","-16650","-40.91","31127695","801294463510"
"079810","���̿�Ƽ","8620","15100","6480","75.17","123102112","2695193989010"
"113810","������","954","1217","263","27.57","717681996","1179875685071"
"043360","��������","3015","3000","-15","-0.50","13301978","43719308160"
"197140","����ĸ","3980","4970","990","24.87","42726795","230625865825"
"068930","�����д뼺","6680","5900","-780","-11.68","7420942","46644883770"
"033130","����Ʋ����","2920","2275","-645","-22.09","85273961","196227319222"
"105740","�����̶�","11250","9090","-2160","-19.20","23825269","260620531300"
"263020","�����̾ص�","2795","3035","240","8.59","29581820","98627931625"
"290550","������Ƽ","8040","8520","480","5.97","28805233","283823447970"
"187220","��Ƽ�ؾ�","4670","8970","4300","92.08","161320582","971020544710"
"383930","��Ƽ�ؾ��˿�","4505","16560","12055","267.59","129677250","1137872736090"
"131180","����","1365","1236","-129","-9.45","16622135","23034651670"
"315640","�����̵�","5516","22750","17234","312.44","187901315","3272365419240"
"317120","��н�","4865","4700","-165","-3.39","29429315","176299703415"
"042510","��½�ť��","2105","2500","395","18.76","200440602","518830401950"
"232680","�����ũ","8750","9570","820","9.37","38187387","408222016260"
"300120","�������","4885","6430","1545","31.63","160710428","1236181016695"
"171120","���̿�����","3505","3305","-200","-5.71","46650840","416365544845"
"388790","������","2265","2710","445","19.65","672837102","2293326228779"
"069540","����Ʈ��","2840","2085","-755","-26.58","387202008","1628947985132"
"347700","�������ø�ƽ��","3694","2275","-1419","-38.41","38605778","190623477770"
"214260","���Ľ�","15900","19680","3780","23.77","28294564","708447075370"
"200350","��������","21200","11510","-9690","-45.71","45020086","909833896360"
"171010","����ũ���","5430","5560","130","2.39","35541521","224786009940"
"084650","������ͽ�","3150","4020","870","27.62","643287979","3715368533855"
"217500","����","2640","3230","590","22.35","196709747","802198298235"
"141080","�����͹��̿�","42850","64800","21950","51.23","91641827","4131276517200"
"038390","����ĸ����","19050","15700","-3350","-17.59","2203357","37242769020"
"294140","����","3084","2365","-719","-23.31","459954725","3359129528343"
"228670","����","23900","23450","-450","-1.88","57235194","1739710224283"
"228850","���̾�","11000","9380","-1620","-14.73","5526900","61954681390"
"412350","��������","6210","9210","3000","48.31","271992503","3271754875240"
"281740","����ũ��Ƽ������","4370","18510","14140","323.57","1016997282","14884594601590"
"277810","���κ���κ�ƽ��","34450","174000","139550","405.08","352161394","39929034256750"
"215100","�κ��κ�","6650","4780","-1870","-28.12","143938292","932008706555"
"090360","�κ���Ÿ","18650","30050","11400","61.13","147330325","4997330359150"
"108490","�κ�Ƽ��","22500","30650","8150","36.22","166127123","5535301213060"
"900260","�ν���","1220","775","-445","-36.48","55445937","54126004136"
"067730","�����ý�","3860","3705","-155","-4.02","49817926","209858100935"
"071280","��ü�ý�����","7970","6380","-1590","-19.95","41714513","309687050030"
"328130","���","14387","79400","65013","451.89","170401819","19401967484050"
"038060","��ེ","1020","1330","310","30.39","131438838","193904641880"
"060240","�����ڸ���","2860","1738","-1122","-39.23","160967371","398603609147"
"058470","�������","155500","223500","68000","43.73","24400985","3880138709740"
"039980","���뽺","857","1070","213","24.85","148803529","148925859756"
"019570","������ �������","1169","659","-510","-43.63","537996986","334715809442"
"016100","�������ڽ���ƽ","3160","2270","-890","-28.16","25479053","91383422320"
"012700","��������","7370","5900","-1470","-19.95","21454873","142381739880"
"302550","���޵�","2470","3280","810","32.79","19394514","226912527115"
"073570","��Ƭ���","14750","7370","-7380","-50.03","311205323","5708691581490"
"377450","������","8900","9010","110","1.24","85944051","814187468320"
"277070","����վƽþ�","4015","4865","850","21.17","121043207","940205107550"
"042500","����Ʈ","4090","4330","240","5.87","42793098","232966156220"
"219420","��ũ���Ͻý�","5900","6910","1010","17.12","61508200","419330035015"
"195500","����Ŀ��������","3005","3090","85","2.83","217591737","947286628155"
"377480","����AI","17400","26550","9150","52.59","244885355","6931543619730"
"305090","����ũ�ε���Ż","3445","6920","3475","100.87","44840140","322891283240"
"098120","����ũ�����ؼ�","5210","14790","9580","183.88","55883945","596281228480"
"038290","��ũ����","19150","21500","2350","12.27","32825485","737940669430"
"267980","��������","52800","41550","-11250","-21.31","2411723","110727896650"
"005990","����Ȧ����","8400","8120","-280","-3.33","1957516","16986200730"
"093520","��Ŀ��","7900","12940","5040","63.80","75782024","914468331120"
"377030","�ƽ�Ʈ","12150","7170","-4980","-40.99","89087338","1161810395570"
"100590","��ť��","5500","5340","-160","-2.91","194623725","1526337822150"
"067280","��Ƽķ�۽�","35300","36050","750","2.12","2507505","91270968250"
"072870","�ް����͵�","10850","10830","-20","-0.18","4153002","46484179670"
"215200","�ް����͵���","79600","60500","-19100","-23.99","14838035","908794282150"
"133750","�ް�����","2645","2535","-110","-4.16","269973215","749151222309"
"235980","�޵�����","19520","7540","-11980","-61.37","61243658","939714999510"
"041920","�޵�Ƴ�","5350","7370","2020","37.76","158098022","1114660163110"
"014100","�޵�ӽ�","3035","3150","115","3.79","23793072","92070917785"
"054180","�޵��۽�","3375","1127","-2248","-66.61","287626720","466982030860"
"086900","�޵��彺","128000","240000","112000","87.50","33730983","7611672033000"
"078160","�޵�����Ʈ","13114","8320","-4794","-36.56","22046257","250411731090"
"065650","�޵�����","1150","1020","-130","-11.30","378012611","675586386085"
"408920","�޽��̻�","3995","2430","-1565","-39.17","84631521","270518260635"
"021880","���̽�ĳ��Ż","336","498","162","48.21","598674620","261283347904"
"140410","������","13000","42900","29900","230.00","104511605","3104573815200"
"241770","��ī��","10800","9240","-1560","-14.44","3177651","35462571270"
"059210","��Ÿ���̿��޵�","2310","4350","2040","88.31","267437774","1042897047215"
"058110","�߾��̾�����","5860","3930","-1930","-32.94","309489152","1464810949190"
"080420","����̳�Ĩ","2940","2460","-480","-16.33","43299937","154472185810"
"417970","�𵨼ַ��","17600","15340","-2260","-12.84","34831688","843985902310"
"080160","�������","17050","15270","-1780","-10.44","27405543","487299427700"
"087260","����Ͼ��ö��̾�","2780","2920","140","5.04","297981090","987120780165"
"101330","���̽�","2875","3430","555","19.30","96353081","390255218835"
"012860","���̽�����","1220","2135","915","75.00","775449830","2103229170497"
"363260","�������","830","664","-166","-20.00","1030992574","1153760441605"
"348030","��񸯽�","11350","8080","-3270","-28.81","7771760","80112359030"
"250060","���","1640","4360","2720","165.85","1368910412","5930023144241"
"288980","��Ƶ���Ÿ","2310","2430","120","5.19","1374343574","5405551603240"
"033200","�����","5500","3695","-1805","-32.82","3728415","20163577020"
"333050","���ڿ��ý�","1475","1390","-85","-5.76","115604760","208447461498"
"118990","��Ʈ����","13600","17750","4150","30.51","207785426","3908796759470"
"006920","������","3480","4000","520","14.94","122521223","614304337390"
"001810","����SP","2605","1838","-767","-29.44","10737063","26124753713"
"279600","�̵����","12250","16900","4650","37.96","18111148","258850291680"
"095500","�̷�������","15000","17490","2490","16.60","527045543","12766382190730"
"218150","�̷������ڿ�","3850","4410","560","14.55","583633824","3799933597700"
"100790","�̷����º�ó����","4270","6040","1770","41.45","79335953","441779351360"
"412930","�̷����º�������1ȣ","2035","2130","95","4.67","15454159","35280081230"
"049950","�̷����۴�","17650","34000","16350","92.63","86554823","3362252980050"
"207760","�̽��ͺ���","3280","1955","-1325","-40.40","654251140","2125395558090"
"059090","����","7330","9490","2160","29.47","306848770","3623795897750"
"214610","���ڹ��̿��޵�","3425","1900","-1525","-44.53","234604141","1378212199096"
"201490","������","3890","3085","-805","-20.69","54916613","195270943290"
"206640","�ٵ��ظ޵�","10250","20300","10050","98.05","70812118","1049784228880"
"018700","�ٸ���","2640","1840","-800","-30.30","67284518","164106233699"
"035620","�ٸ����̾ؿ���","998","659","-339","-33.97","86855756","73582156449"
"053030","���̳ؽ�","11550","9370","-2180","-18.87","53035412","524917566800"
"301300","���̺����۴�","9418","7150","-2268","-24.08","26143561","497916427250"
"064550","���̿��Ͼ�","29400","34050","4650","15.82","238043856","11722351200700"
"314930","���̿�����","22800","63800","41000","179.82","8384153","441607227250"
"208710","���̿��α׵���̽�","990","879","-111","-11.21","218268131","272586979785"
"086820","���̿��ַ��","10600","21100","10500","99.06","10201649","153394350730"
"038460","���̿�����Ʈ","3330","3410","80","2.40","41756132","153365193395"
"251120","���̿������𿣾�","17000","14620","-2380","-14.00","11428845","184133152060"
"086040","���̿��彺��","8140","6870","-1270","-15.60","56040938","468921459820"
"099430","���̿��÷���","6940","6920","-20","-0.29","242414292","1838321525960"
"032980","���̿�","1255","1298","43","3.43","147934388","217357542996"
"222160","���̿�Ʈ��","4540","8800","4260","93.83","69016759","501388055785"
"308080","��������","7120","6160","-960","-13.48","16214852","107750862120"
"043150","����","32800","33300","500","1.52","16705220","596158485175"
"323990","�ڼ����̿�","26708","24550","-2158","-8.08","180087993","7368933917110"
"267790","�跲","7000","7820","820","11.71","7419600","58329394610"
"046310","���T&A","3060","3155","95","3.10","47776343","163925776075"
"331520","�����","1070","1038","-32","-2.99","482227838","740399036380"
"066410","��Ŷ��Ʃ���","1620","1153","-467","-28.83","112569084","172630893748"
"382900","����ǻ��","26100","20700","-5400","-20.69","19908491","501850244850"
"206400","����Ƽ�ؾ�","2400","3410","1010","42.08","67214699","274353297235"
"019010","������","2150","2080","-70","-3.26","15940795","34940051186"
"177350","����","2188","800","-1388","-63.44","252452294","780084202702"
"299910","������","3165","3165","0","0.00","0","0"
"424760","����ũ","2435","1528","-907","-37.25","32444346","86922754594"
"225530","�������","5680","5370","-310","-5.46","19531519","123324763415"
"250000","����Ƽ��","10700","11200","500","4.67","84456705","1483621249510"
"310210","���γ���","27971","52100","24129","86.26","41221887","2042914900500"
"006910","�����Ŀ���","3720","3240","-480","-12.90","276241827","1096883580755"
"226340","����","1660","2255","595","35.84","262957615","634169243880"
"014470","�ι�","2150","3010","860","40.00","412805112","1336659638705"
"008470","�ν�Ÿ","4870","4700","-170","-3.49","4036594","20521489560"
"338220","���","6240","40100","33860","542.63","227220074","7692352564120"
"100120","�����","30150","26850","-3300","-10.95","5975180","189452895300"
"337930","�귣�忢�����۷��̼�","4770","6230","1460","30.61","92053818","541773700160"
"099390","�극�������۴�","6740","7540","800","11.87","35255300","369840508520"
"064480","�긮����","4020","7020","3000","74.63","319473187","3164530070910"
"288330","�긴�����̿��׶�ǻƽ��","11600","3415","-8185","-70.56","33983956","192709520655"
"365900","���̾�","7690","4430","-3260","-42.39","14235348","100135019390"
"251630","���̿���","6260","12170","5910","94.41","66448104","719860496530"
"018290","����Ƽ","5250","17330","12080","230.10","239111790","2846509006180"
"044480","�����̵� Ent","1495","1129","-366","-24.48","57026454","83000443322"
"033560","������","3700","3130","-570","-15.41","89548840","474951991015"
"369370","����������","2015","2260","245","12.16","21545879","47122754846"
"126340","����","38159","47350","9191","24.09","15628643","955087832850"
"121800","��Ʈ","3085","3320","235","7.62","239271932","978934757200"
"148140","������","6140","6140","0","0.00","0","0"
"082800","���� ����","3185","3120","-65","-2.04","616024875","728482216848"
"318410","���","8700","9240","540","6.21","4258968","40853972870"
"419540","���佺","2385","2240","-145","-6.08","343280565","1003674622958"
"146320","�񾾿���","15100","23550","8450","55.96","41775462","839552697990"
"200780","�񾾿�������","8470","6620","-1850","-21.84","3953971","27173763200"
"141000","���Ʈ��","8630","9070","440","5.10","17883929","176603190670"
"083650","����ġ����","6490","7910","1420","21.88","136844692","1108994055270"
"445360","��������1ȣ����","1995","2095","100","5.01","3068278","6284740235"
"142760","��","3570","2210","-1360","-38.10","132661420","453931261323"
"065170","������","625","510","-115","-18.40","338560863","231878679444"
"086670","��Ƽ","14900","13460","-1440","-9.66","19522767","287651343420"
"335890","���","3225","8580","5355","166.05","542541253","3358713185405"
"230980","������ũ���","655","508","-147","-22.44","491556154","366843904395"
"138580","����Ͻ���","6820","13250","6430","94.28","24977253","320418786500"
"082920","�����μ�","12750","16920","4170","32.71","85055476","1660299005275"
"054220","�����νý�","982","592","-390","-39.71","230901055","199833079322"
"042370","��������ũ","6710","7670","960","14.31","355001255","3309912501620"
"050090","������Ȧ����","1553","1109","-444","-28.59","148541240","130730088559"
"307870","������","1980","2210","230","11.62","240572617","698177350197"
"357880","��Ʈ����","6860","6050","-810","-11.81","183333875","1946166503460"
"032850","��Ʈ��ǻ��","6140","5960","-180","-2.93","99874539","656956967830"
"148780","���ö��̼���Ʈ","894","1375","481","53.80","422135995","623097082580"
"238200","���ǵ�","8500","5550","-2950","-34.71","17392384","141200124005"
"093190","��ַ�","7000","5680","-1320","-18.86","17389677","107622943930"
"065450","����","5680","4215","-1465","-25.79","359985731","1874874448185"
"072950","��������","4437","4540","103","2.32","16373255","83597047740"
"143240","�����","26400","17870","-8530","-32.31","6966707","142604200495"
"419120","�굹","12850","9240","-3610","-28.09","23803924","309656632152"
"122350","���","3375","2205","-1170","-34.67","136799292","424851299055"
"014970","�︢����","4775","3560","-1215","-25.45","12866229","68692153315"
"018310","��񿡽���","16700","16370","-330","-1.98","8040718","129549136770"
"053700","�ﺸ���ͽ�","5000","6000","1000","20.00","142867922","941388899380"
"009620","�ﺸ���","864","1278","414","47.92","274969132","341422289850"
"023600","�ﺸ����","10250","9490","-760","-7.41","4554086","43678060680"
"380320","�Ｚ�ӽ�Ʈ����5ȣ","3120","2040","-1080","-34.62","31415360","115256394645"
"425290","�Ｚ����6ȣ","2800","2265","-535","-19.11","98124437","349011374470"
"439250","�Ｚ����7ȣ","9910","9730","-180","-1.82","5505621","55569805280"
"009300","�������","16650","16450","-200","-1.20","4817462","82916480330"
"225190","����ƽ��","9910","9410","-500","-5.05","2860311","29308201300"
"361670","�￵�����ؾ�","7650","5260","-2390","-31.24","6663894","49184363800"
"054540","�￵����","3650","4275","625","17.12","41769468","172289511150"
"065570","�￵�̿���","4500","3030","-1470","-32.67","36784526","177001875610"
"032280","����","1965","1953","-12","-0.61","11857524","23770861182"
"002290","���ϱ������","3730","4220","490","13.14","17152794","64806189925"
"037460","��������","8330","8480","150","1.80","12967316","111687035560"
"032750","����","5488","5700","212","3.86","79133181","582475446600"
"054090","�������ص�","2520","1709","-811","-32.18","137733656","400882076903"
"000250","��õ������","43800","79900","36100","82.42","125467382","8779462312800"
"024950","��õ��������","7340","6560","-780","-10.63","28232801","195053454130"
"038500","��ǥ�ø�Ʈ","3355","3120","-235","-7.00","48542510","167125204775"
"017480","����ö��","4870","5050","180","3.70","7986777","42122264685"
"046390","��ȭ��Ʈ����","3390","2020","-1370","-40.41","157016073","477863548967"
"027580","��","1355","1681","326","24.06","1575182390","3204703706977"
"038540","�����","6130","3800","-2330","-38.01","43573983","214542561615"
"101000","������δ���Ʈ��","2418","2205","-213","-8.81","67143896","91605286183"
"415580","�������3ȣ����","1975","2070","95","4.81","3410302","7325323954"
"091580","����̵���","14900","15750","850","5.70","113697241","2564514612360"
"263810","�������","3095","4565","1470","47.50","257056238","1484051607865"
"089980","���������ũ","27100","22200","-4900","-18.08","27064442","766206914210"
"042940","����ī�Ϸ�","501","407","-94","-18.76","345447947","183625854552"
"042600","���δн�","14950","31600","16650","111.37","54805546","2282434507610"
"107600","������","76300","68500","-7800","-10.22","28832776","3018096982000"
"252990","����������","3960","5800","1840","46.46","99009927","584457600075"
"378800","�����","7100","3730","-3370","-47.46","288732787","1743399319830"
"294630","����","2075","4330","2255","108.67","1090746669","6918732814747"
"038070","�������̿�","11387","9410","-1977","-17.36","15445692","182720666600"
"006730","����T&D","7070","7300","230","3.25","60354543","489221337750"
"079650","����","1900","1608","-292","-15.37","6284511","11368821411"
"100660","���ϱ�����","5850","4570","-1280","-21.88","30960275","177477580940"
"019770","����ž��Ż","3965","4495","530","13.37","58506303","269720040605"
"043710","���︮��","846","740","-106","-12.53","53558117","49265571065"
"092190","������̿��ý�","5010","4000","-1010","-20.16","55025065","331683549595"
"046890","����ݵ�ü","10100","10520","420","4.16","139227295","1709722240960"
"063170","�������","17650","12910","-4740","-26.86","126090478","2127891131500"
"027040","�����������","599","431","-168","-28.05","25578515","13305483510"
"018680","��������","5030","3880","-1150","-22.86","9767856","43634448775"
"093920","��������","5740","5860","120","2.09","34315809","226154576600"
"189860","��������","5950","4360","-1590","-26.72","60146374","377197711845"
"178320","�����ý���","17500","18310","810","4.63","118320172","2058132627560"
"122690","���������Ƽ��","2710","3605","895","33.03","72016385","279583677345"
"140070","���÷����۷ι�","3490","3725","235","6.73","232293507","1034932953280"
"011370","����","1130","961","-169","-14.96","87829539","94811562487"
"065710","��ȣ����","17800","18870","1070","6.01","1385110","25881579570"
"035890","����Ǽ�","1130","1370","240","21.24","317646948","463638581282"
"357550","���濡��Ƽ","23400","55800","32400","138.46","50842416","2724828005700"
"003100","����","134100","17850","-116250","-86.69","35302883","1468418182830"
"067370","�����̿�","11150","11300","150","1.35","19607234","249761358970"
"171090","���ͽý���","22150","31450","9300","41.99","120139567","3737531329910"
"086710","������Ƽ���̾�","6730","8180","1450","21.55","54791837","478268123200"
"014620","��������","13250","12320","-930","-7.02","88709172","1231105196330"
"037350","�����̿���","4460","4040","-420","-9.42","37313922","168813917680"
"081580","��������","2585","2205","-380","-14.70","67953523","194602491381"
"045300","������ũ��","3828","4255","427","11.15","77602950","379563958400"
"015750","����������","4675","9500","4825","103.21","1035849715","10099783602275"
"365340","����������","101700","106400","4700","4.62","59935022","8672107856300"
"080470","��â������","6890","5090","-1800","-26.12","8539600","56136261995"
"043260","��ȣ����","1185","1430","245","20.68","620757753","1089531784549"
"148150","����������ũ","3954","6170","2216","56.04","44440902","588818461990"
"053060","����","1405","1909","504","35.87","118386549","252302439685"
"340440","����B&G","2090","1882","-208","-9.95","178480109","486807966129"
"017510","��������","2990","2820","-170","-5.69","18575029","60501130560"
"011560","�������̾�","7600","8690","1090","14.34","16833859","150449520950"
"396300","���Ƹ�ī�н�","4485","4150","-335","-7.47","305058597","1998363579275"
"100700","����޵�Į","2920","2865","-55","-1.88","14395486","40663350550"
"024830","��������","7960","6500","-1460","-18.34","5649032","48452171280"
"258830","�����޵�Į","2865","1159","-1706","-59.55","570204322","1547580406185"
"036630","�����ڷ���","649","757","108","16.64","218233392","160270514016"
"039310","����","2580","2415","-165","-6.40","18878294","52456855179"
"067770","����Ƽ����","3060","2920","-140","-4.58","19288121","69181172695"
"053450","���ڴн�","5370","7140","1770","32.96","64169631","496466828420"
"222810","�����Ǿ�","1055","2150","1095","103.79","576179619","1678760522312"
"252500","��ȭ�Ǿؾ�","1280","909","-371","-28.98","82006827","97931497599"
"347000","����","3190","2925","-265","-8.31","244027629","1013152199441"
"331920","�����ͽ�","5800","4480","-1320","-22.76","20935649","113582592010"
"049180","����޵�","4385","2135","-2250","-51.31","284050431","1429634705592"
"299660","������","10724","4755","-5969","-55.66","23003565","156794123550"
"268600","��������","12000","6680","-5320","-44.33","50038626","597569387270"
"108860","���ٽ�AI","6493","20800","14307","220.34","852012250","18018917550430"
"208370","���ٽ��ｺ�ɾ�","2021","6970","4949","244.88","719937035","6141425908430"
"068760","��Ʈ��������","63793","119800","56007","87.79","91357930","7675647704900"
"091990","��Ʈ�����ｺ�ɾ�","58000","75900","17900","30.86","203581391","13745918929748"
"068940","���Ǳ۷ι�","1335","778","-557","-41.72","100033633","129249011349"
"060230","�Ҵϵ�","3175","2050","-1125","-35.43","760157832","4002345455768"
"290690","�ҷ轺","427","5210","4783","1120.14","133159104","3073857417395"
"950200","�Ҹ���","7760","5190","-2570","-33.12","31175226","235589858365"
"032680","����Ʈ��","624","594","-30","-4.81","1293032182","1498170963563"
"032685","����Ʈ����","8080","10710","2630","32.55","1220431","24928318570"
"258790","����Ʈķ��","1670","1473","-197","-11.80","151465194","304936767495"
"066910","�տ���","1800","2970","1170","65.00","132285353","333930438345"
"043100","�ְ����̿�","468","420","-48","-10.26","96258857","46672036085"
"035610","�ֺ�","3630","4095","465","12.81","113554434","581843911875"
"357780","�ֺ극��","217900","309000","91100","41.81","7093711","1759089448010"
"036830","�ֺ극��Ȧ����","23800","44350","20550","86.34","34422915","1163043319300"
"304100","��Ʈ�轺","14750","26700","11950","81.02","342796044","10746897870862"
"328380","��Ʈ����","1185","1509","324","27.34","1051817594","1868400397466"
"086980","��ڽ�","3675","3485","-190","-5.17","166095974","622785197210"
"050960","������̾�Ƽ","10700","10590","-110","-1.03","13778556","184566677160"
"084180","�������ٽÿ�","1565","592","-973","-62.17","506883060","538080841413"
"253840","������","10150","7790","-2360","-23.25","76889277","706862701850"
"236200","��������","21650","20800","-850","-3.93","11970362","277131611720"
"094840","������������ġť","5400","6900","1500","27.78","51821034","400339447210"
"192440","���ǰ��ڸ���","33100","32650","-450","-1.36","1888652","62425378850"
"136510","����Ʈ�ַ����","11600","11600","0","0.00","0","0"
"099440","����","1740","4250","2510","144.25","587010771","2155218900141"
"033790","��ī�̹�����ũ�����","1658","1470","-188","-11.34","124445903","228452164357"
"276040","���ڳ�","15250","8570","-6680","-43.80","57756664","791268954142"
"159910","��Ų�ؽ�Ų","2842","684","-2158","-75.93","1973215303","304237384356"
"115570","��Ÿ�÷���","4990","3080","-1910","-38.28","7180375","30907975120"
"330730","����긴����ó��","4515","6250","1735","38.43","101715063","559534404875"
"253450","��Ʃ����巡��","86000","52300","-33700","-39.19","36749023","2345845249400"
"204630","��Ʃ�����ŸŬ�ν�","1403","362","-1041","-74.20","934586466","721238140234"
"013810","������","4580","3340","-1240","-27.07","87641735","401723639645"
"203690","���Ǿ��Ŀ�","4940","10620","5680","114.98","44510824","226466061216"
"049830","����","11850","10190","-1660","-14.01","3814786","43756363940"
"020710","�ð���ũ","4200","4405","205","4.88","69078625","385552066730"
"033170","�ñ׳�ƽ��","1030","1280","250","24.27","497761947","776305924123"
"048870","�ó����̳뺣�̼�","2790","2775","-15","-0.54","113832640","372745743680"
"025320","�ó��彺","2325","7970","5645","242.80","694514344","3037010153810"
"269620","�ý���","889","889","0","0.00","0","0"
"131090","��ť��","1020","1023","3","0.29","26366657","28218957894"
"139050","��Ƽ����","9832","6290","-3542","-36.03","183745920","142479047078"
"290520","�ŵ��⿬","5090","4125","-965","-18.96","136375540","939993771860"
"001000","�Ŷ���","1945","1642","-303","-15.58","96269097","202214847149"
"025870","�Ŷ󿡽���","9700","7810","-1890","-19.48","18213416","194400947060"
"215600","�Ŷ���","6970","6030","-940","-13.49","341984597","2105340246880"
"065350","�ż���Ÿ��ũ","7800","41550","33750","432.69","568753978","20764357554220"
"162300","�Ž�ƿ","8730","2995","-5735","-65.69","347031920","1814529799143"
"002800","�Ž�����","5580","6360","780","13.98","197328628","1361759849660"
"419270","�ſ�����7ȣ","2050","2425","375","18.29","2467078","5479824380"
"430220","�ſ�����8ȣ","2025","2110","85","4.20","3628273","7646912565"
"445970","�ſ�����9ȣ","2020","2085","65","3.22","7344462","15731527035"
"017000","�ſ����հ���","4340","3595","-745","-17.17","61115738","310359829940"
"012790","��������","8500","7740","-760","-8.94","13483201","109908093280"
"138070","����������","2655","2845","190","7.16","63568057","199223699815"
"226330","����ī���̿�","8580","14260","5680","66.20","202521070","2803960987860"
"418210","������10ȣ����","2025","2195","170","8.40","2372348","5076600655"
"393360","������8ȣ����","1768","2040","272","15.38","3728326","7874403490"
"405640","������9ȣ����","2030","2390","360","17.73","2960229","6521500640"
"056700","��ȭ������","3365","2195","-1170","-34.77","60639526","185505283924"
"187270","��ȭ����","4140","4680","540","13.04","73554205","379993450985"
"243840","���￡���̾�","41300","46500","5200","12.59","14350555","709813171900"
"257720","�Ǹ�����","2455","7830","5375","218.94","1214569532","6168181755700"
"222800","����","26450","42200","15750","59.55","145890251","4950597508650"
"036710","����Ȧ����","2840","3410","570","20.07","126247793","420284646125"
"160980","���̸ƽ�","11600","14660","3060","26.38","18211107","262937897020"
"356890","���̹���","8550","9210","660","7.72","14394556","164041140920"
"217330","��������","16200","13810","-2390","-14.75","11990450","188920483790"
"010280","�ֿ��������","789","905","116","14.70","213341708","209347297474"
"208640","�濡����","610","422","-188","-30.82","166581930","86925410876"
"222420","�����","1685","1605","-80","-4.75","262191496","554258652833"
"037760","���Ʈ","1610","1532","-78","-4.84","16980642","27701498756"
"099320","��Ʈ������","30000","33400","3400","11.33","17440308","653482450650"
"049960","����̿���","12700","11100","-1600","-12.60","3398803","46450751840"
"050890","�򸮵�","5800","6080","280","4.83","273463844","1674289578415"
"066790","��������","517","1927","1410","272.73","1111128363","2681065906077"
"222080","�����̿���","9000","11190","2190","24.33","397258770","5110443700850"
"352480","���ؾ����ͳ��ų�","30400","62700","32300","106.25","27745066","1329955451900"
"264660","������������ũ","11750","12710","960","8.17","3982187","52912193950"
"352700","��������","4400","3410","-990","-22.50","26086769","107030594395"
"297090","���������","8100","10900","2800","34.57","136800306","1573301647190"
"900120","����������","220","139","-81","-36.82","661689346","97540876023"
"359090","�����˸���ġ","1140","1216","76","6.67","75284769","98146394804"
"115530","�����÷���","500","360","-140","-28.00","148225400","79811356944"
"115480","�����޵�Į","1305","856","-449","-34.41","110452379","129176283549"
"376290","������ũ","4080","3520","-560","-13.73","12671227","60454450805"
"189330","���̷�","13400","10970","-2430","-18.13","77596293","1673611607900"
"096530","����","27200","23000","-4200","-15.44","109074986","2613565287205"
"101240","��ť��","6641","4980","-1661","-25.01","122933212","982600402795"
"060590","��Ƽ�����̿�","6300","10280","3980","63.17","95104316","1093799781590"
"260930","��Ƽ����","5390","5810","420","7.79","31318267","199938183245"
"052300","��Ƽ������Ƽ","511","490","-21","-4.11","304132064","142388465340"
"013990","�ư������۴�","3410","4335","925","27.13","163444985","623725522595"
"123860","�Ƴ��н�","24200","23000","-1200","-4.96","17229315","322784890130"
"025980","�Ƴ�Ƽ","6680","6600","-80","-1.20","272771007","2048644070070"
"058220","�Ƹ���","275","275","0","0.00","0","0"
"125210","�Ƹ�׸���","11800","12800","1000","8.47","129557786","2151312946880"
"357580","�Ƹ𼾽�","12200","11900","-300","-2.46","64002848","1072084531100"
"052710","�Ƹ���","16160","8170","-7990","-49.44","66012909","878523024150"
"074430","�ƹ̳������","1830","1500","-330","-18.03","220574944","353233767526"
"092040","�ƹ�����","8992","7750","-1242","-13.81","41450941","604508190580"
"083930","�ƹ���","12800","15310","2510","19.61","85675669","1610719911500"
"149950","�ƹ���","15000","14540","-460","-3.07","8768000","137213950210"
"036010","�ƺ�������","10100","15170","5070","50.20","107541189","1575452509400"
"050860","�Ƽ�����","2505","2505","0","0.00","58967169","166477650155"
"136410","�Ƽ���","9850","6900","-2950","-29.95","13300659","131787893610"
"246720","�ƽ�Ÿ","3940","6250","2310","58.63","70492649","690249648490"
"067390","�ƽ�Ʈ","3995","2005","-1990","-49.81","116480136","264819459282"
"159010","�ƽ��÷�","9590","10640","1050","10.95","29093265","372114761370"
"127710","�ƽþư���","1660","1222","-438","-26.39","21129815","32837590304"
"154030","�ƽþ�����","3245","3005","-240","-7.40","17340306","63448444930"
"227610","�ƿ��ǻ�Ľ�","4510","2015","-2495","-55.32","331173699","920230231439"
"143160","���̵�","22150","22600","450","2.03","12790888","303962143060"
"054800","���̵�Ȧ����","12600","11260","-1340","-10.63","1084320","14067194180"
"332370","���̵���","4540","3380","-1160","-25.55","12720365","52599903570"
"339950","���̺�迵","1915","1871","-44","-2.30","201222546","457585898996"
"099190","���̼���","16464","26900","10436","63.39","116209616","3379585374800"
"289010","���̽�ũ������","4010","3935","-75","-1.87","85561068","420181948205"
"214430","���̾����ý���","18550","32300","13750","74.12","17368738","521912039670"
"040910","���̾���","8870","9150","280","3.16","24836824","277932916410"
"368600","���̾�����ġ","6830","5530","-1300","-19.03","77126237","549117075590"
"052860","���̾ؾ�","2495","2785","290","11.62","22166164","59533368195"
"069920","���̿�����Ŀ�ӽ�","7790","3335","-4455","-57.19","57896271","259102805732"
"038880","���̿���","607","485","-122","-20.10","432838539","254695094746"
"307180","���̿����̾�","2810","3390","580","20.64","34082110","124743976230"
"101390","���̿�","5050","6000","950","18.81","55455222","474524504804"
"078860","���̿�����","8698","3825","-4873","-56.02","281078404","99120199111"
"090150","������","1260","1240","-20","-1.59","315930933","641534618787"
"123010","�������÷���","2240","1655","-585","-26.12","92149970","203968497995"
"031310","���������","2680","3315","635","23.69","146754331","475595754525"
"185490","������","5030","4375","-655","-13.02","33036187","143308063100"
"059100","����������Ʈ","6700","8460","1760","26.27","33375353","264186030365"
"262840","��������Ʈ","6610","5610","-1000","-15.13","10456970","79108607050"
"175250","����ť��","2555","2150","-405","-15.85","155945915","537425360094"
"052460","����ũ����Ʈ","2375","3850","1475","62.11","280777032","1275326416710"
"119830","������","6680","7080","400","5.99","52745252","499998758030"
"052770","�������","1800","1096","-704","-39.11","114567119","197557038128"
"124500","����Ƽ��","3590","7430","3840","106.96","242150362","1306040247205"
"372800","����Ƽ������","7450","7180","-270","-3.62","35560586","392910625270"
"084850","����Ƽ���ݵ�ü","26200","27800","1600","6.11","9125757","226635572835"
"114840","�����йи�������","12450","26050","13600","109.24","26928347","570742825750"
"027360","����IB����","2215","2845","630","28.44","176229473","455228137475"
"032080","������WB","1850","1666","-184","-9.95","34695965","65639721068"
"013310","�������","2360","4370","2010","85.17","764682169","3996693375620"
"059120","����������","7790","10420","2630","33.76","128752918","1399039723520"
"158430","����","4320","4355","35","0.81","47997443","312198926010"
"067160","������īTV","71100","84700","13600","19.13","59829681","4715086292400"
"001540","�ȱ���ǰ","9190","9950","760","8.27","24327360","216386152780"
"053800","�ȷ�","66700","68900","2200","3.30","42397515","3292805552900"
"065660","��Ʈ����","14700","16600","1900","12.93","17028457","341708826210"
"297570","�˷��̽�","1480","1565","85","5.74","224381000","394884573273"
"260660","�˸�������","6550","5780","-770","-11.76","13517880","90685837840"
"361570","�˺������","4372","4040","-332","-7.59","68449667","625486690698"
"131370","�˼���Ʈ","4230","3700","-530","-12.53","156761677","670099413150"
"140670","�˿���������̼�","11800","15280","3480","29.49","100759776","1595435655710"
"096610","�˿�������","2310","3690","1380","59.74","190477934","2234328976675"
"061040","�˿�����","5370","3955","-1415","-26.35","41303563","196908437175"
"148250","�˿�����ũ�����","9530","4790","-4740","-49.74","22941950","183859174320"
"347860","��ü��","6590","8250","1660","25.19","204656783","2675569642610"
"196170","���׿���","38250","91500","53250","139.22","260462927","15472283008800"
"123750","���潺����","3905","3405","-500","-12.80","75942683","332145145670"
"085810","��Ƽĳ��Ʈ","1760","1129","-631","-35.85","105151332","202134460289"
"117670","����Ȧ����","1170","945","-225","-19.23","51427366","65174445515"
"314140","���ǹ��̿�","12550","8870","-3680","-29.32","31889424","431231805820"
"291650","��Ÿ�ӻ��̾�","4375","3635","-740","-16.91","80167556","389548076735"
"293780","��Ÿ���̿�","10650","9080","-1570","-14.74","63850295","684323904670"
"196300","�ִ���","7410","14380","6970","94.06","15618520","248055238900"
"310200","�ִ��÷���","4740","3400","-1340","-28.27","196402374","823190327135"
"179530","�ֵ���̿���","3360","3500","140","4.17","23296122","94475269550"
"900100","�ָӸ���","1525","1726","201","13.18","84097111","197178248176"
"205500","�׼ǽ�����","3185","1668","-1517","-47.63","44833849","100844546648"
"052790","���������Ʈ","7790","8900","1110","14.25","31298164","298076655760"
"290740","��Ʈ��","5990","8040","2050","34.22","28055094","228078308410"
"238090","�ص�����","5317","4645","-672","-12.64","55895596","200843781320"
"092600","�ؾ���","1520","1657","137","9.01","67763796","131510232333"
"129890","����","1206","857","-349","-28.94","37812260","147164358672"
"174900","��Ŭ��","12800","14930","2130","16.64","52859196","982783290850"
"255440","�߽�","7840","11080","3240","41.33","68974295","860794179760"
"030960","������","31900","13090","-18810","-58.97","151460885","3068868003330"
"102120","���ݵ�ü","8100","14720","6620","81.73","153970177","1836597878460"
"263540","��ؿ���ν����̽�","5950","5950","0","0.00","0","0"
"238120","����ε�","3765","4060","295","7.84","40688698","356880163275"
"019990","������ũ","9950","6520","-3430","-34.47","36092118","340131848640"
"270660","���긮��","14750","12070","-2680","-18.17","95616046","1608859500980"
"038680","������","4715","4900","185","3.92","124110885","707874203590"
"217480","�������������","1270","349","-921","-72.52","176176217","139284438041"
"121890","������ý���","1478","1970","492","33.29","32125518","69907184520"
"389500","���������ũ","17200","39750","22550","131.10","143071771","6964826451741"
"042110","��������","1835","1761","-74","-4.03","66576376","126002836429"
"298060","����������������","11018","4090","-6928","-62.88","72862865","517319609085"
"065420","�������̸��ҽ�","414","280","-134","-32.37","535643140","256270660811"
"103230","�����ش�����","4300","4015","-285","-6.63","32018496","184574969235"
"260970","�����ص�","15800","18300","2500","15.82","2484066","39532564140"
"101490","�����ؿ�����","26350","46500","20150","76.47","111728917","5107003877600"
"095910","����������","3040","2005","-1035","-34.05","42087513","119920655643"
"275630","����������","5960","5090","-870","-14.60","17437099","102300203835"
"031330","�������̿�Ƽ","2690","2860","170","6.32","84005193","243638028095"
"060540","��������Ƽ","2060","2680","620","30.10","101766066","283091571143"
"351320","��������Ƽ�̿���","2760","2670","-90","-3.26","109715034","458628493430"
"056190","������������","36400","30750","-5650","-15.52","29815059","1061415309614"
"080000","��������","2910","2965","55","1.89","127485772","523055239857"
"214310","������������","306","306","0","0.00","0","0"
"041510","������","76700","93300","16600","21.64","158341080","17824749796116"
"007820","�������ھ�","5700","5480","-220","-3.86","50046227","359068088625"
"109610","��������","3920","4650","730","18.62","1202788265","6311149389660"
"031860","������Ȧ����","687","409","-278","-40.47","728258229","552163280911"
"306040","�������̱׷�","16400","9430","-6970","-42.50","5939311","78100331710"
"435870","��������������8ȣ����","2070","2240","170","8.21","3686121","8316949825"
"096630","�����ڳ�","943","1686","743","78.79","1098684507","2106762943149"
"069510","������","8240","8800","560","6.80","2134387","18199450800"
"041910","�������ĸ�","7090","6960","-130","-1.83","17245321","133315006140"
"234300","����Ʈ����","3825","3940","115","3.01","208961654","1137366114435"
"039440","����Ƽ����","11950","29800","17850","149.37","122358779","3046730793580"
"098660","����Ƽ��","2420","2180","-240","-9.92","13709696","35690476900"
"052020","����Ƽť��","14350","11610","-2740","-19.09","156723012","2393178334610"
"237690","����Ƽ��","87600","67900","-19700","-22.49","23404610","1827145132400"
"050760","����������","2380","2220","-160","-6.72","26795751","65924194220"
"288620","����ǻ��","20300","17050","-3250","-16.01","14903893","291808252450"
"317830","�����ǽý��۽�","7160","9940","2780","38.83","235832412","3276239649400"
"058610","��������","17200","36100","18900","109.88","462821317","14492716791820"
"043340","������ũ","875","737","-138","-15.77","28352389","25593295982"
"187660","���̵��ڸ���","2060","1967","-93","-4.51","179493262","458855097147"
"054630","���̵�Ĩ��","377","302","-75","-19.89","859682147","473174246845"
"200710","���̵���ũ�����","12300","32850","20550","167.07","135547855","3244759650326"
"096690","���̷�Ʈ","417","507","90","21.58","258840125","128101871770"
"298380","���̺񿤹��̿�","23000","24100","1100","4.78","119411474","2519181703470"
"203400","���̺��","6730","8430","1700","25.26","23839099","178552243505"
"195990","���̺����ι��̿�","422","613","191","45.26","1090310734","685286993302"
"003800","���̽�ħ��","35900","26450","-9450","-26.32","703160","20952703250"
"088800","���̽���ũ","5923","1923","-4000","-67.53","472737268","1313604834413"
"241840","���̽��丮","25350","13800","-11550","-45.56","19679759","414017595460"
"312610","���̿���������","3180","2840","-340","-10.69","100082046","479435027280"
"072990","����ġ��Ƽ","7863","8630","767","9.75","6134383","50218185840"
"227100","����ġ�غ������","3760","3435","-325","-8.64","58095650","175372030801"
"239610","����ġ�����̾�","18600","15870","-2730","-14.68","6854690","122472864090"
"148930","����ġ����Ƽ��","9110","6810","-2300","-25.25","39360469","394414882130"
"044780","����ġ����","1945","1805","-140","-7.20","26691481","52394447881"
"357230","����ġ�ǿ�","6994","7880","886","12.67","26661356","226405433150"
"071670","������ũ�ַ��","8090","10960","2870","35.48","55087224","667697530910"
"045660","������","8600","15280","6680","77.67","38554620","461797394140"
"224110","�����ظ����Ƽ","9610","15740","6130","63.79","38071633","537573274420"
"021080","����Ƽ���κ���Ʈ","2620","3500","880","33.59","89126669","265172702950"
"089530","����Ƽ������","1000","600","-400","-40.00","252580985","205816798785"
"200470","������Ʈ","2475","3540","1065","43.03","145366171","525178529700"
"262260","��������","10800","14030","3230","29.91","65170467","1091601687820"
"109960","���������� H&G","2236","805","-1431","-64.00","208530185","238392062211"
"397030","�����������̿�","8779","15790","7011","79.86","44515582","867189274840"
"089970","������Ƽ��","10600","14450","3850","36.32","31373554","473002685830"
"230240","��ġ������","37000","17650","-19350","-52.30","59252160","1567671463440"
"230360","���ڸ�����","14450","10420","-4030","-27.89","30898547","350064032570"
"038870","���ڹ��̿�","4640","5940","1300","28.02","310130993","2221867947575"
"097780","���ں�Ʈ","1380","1074","-306","-22.17","99443276","148363108901"
"101360","���ھص帲","24150","21850","-2300","-9.52","84804875","3313896370400"
"128540","����ĸ","3850","2850","-1000","-25.97","68249672","302941038645"
"086520","��������","103000","638000","535000","519.42","261820107","169152589550900"
"247540","�������κ�","92100","283500","191400","207.82","446917396","115815516662100"
"383310","�������ο���ġ��","45350","67400","22050","48.62","160516498","13490645392600"
"038110","�����ö�ƽ","2545","5030","2485","97.64","1227149150","6890877609165"
"073540","��������","2860","2435","-425","-14.86","9259323","23920460553"
"064850","�����ذ��̵�","6400","6540","140","2.19","4862314","37241017520"
"036810","��������Ƽ","15600","24800","9200","58.97","91521673","2149528895330"
"173940","������������","5400","5030","-370","-6.85","7087808","45894308195"
"083500","������������ũ","6940","11720","4780","68.88","23790582","228950757170"
"054940","�����̿���","1345","886","-459","-34.13","171064948","199742667128"
"043090","������21","1925","691","-1234","-64.10","228151367","313552513007"
"950130","���������̿�","12200","9030","-3170","-25.98","219929374","2480712974600"
"205100","����","1860","2165","305","16.40","315841859","1557364203910"
"070300","����ť��","3000","3010","10","0.33","7673829","22996333795"
"317770","�����丯��","2115","6350","4235","200.24","214108388","2032655255970"
"092870","������","9090","21500","12410","136.52","67942771","1057971085000"
"317870","�����̿��Ͼ�","5230","14310","9080","173.61","17478563","195038941900"
"067570","�����̿���ġ�ڸ���","3112","2690","-422","-13.56","59039737","228317154170"
"236810","����Ƽ","5460","7810","2350","43.04","203564944","1504498148310"
"333620","���ý�","9960","10040","80","0.80","19656566","271563194270"
"101400","����Ʈ��","706","637","-69","-9.77","84712487","59703481951"
"391060","������ġ����20ȣ","9800","9790","-10","-0.10","3351467","16189837039"
"422040","������ġ����23ȣ","2140","2085","-55","-2.57","4370593","9213470550"
"437780","������ġ����24ȣ","1960","2100","140","7.14","2179525","4567030655"
"438580","������ġ����25ȣ","2190","2460","270","12.33","1667323","3862071325"
"439410","������ġ����26ȣ","1995","2005","10","0.50","5314553","10926006102"
"440820","������ġ����27ȣ","1980","2030","50","2.53","4437646","9112653512"
"265740","��������","8750","8760","10","0.11","8962076","81065162060"
"354200","�������̿�","9280","5630","-3650","-39.33","43452976","348804736785"
"419080","����","12600","15390","2790","22.14","53080656","981995597590"
"208860","��������ũ�η���","2205","2205","0","0.00","0","0"
"183490","�����ͻ�������","1655","1802","147","8.88","115475640","198542600850"
"182400","�����̸ƽ�","6850","6480","-370","-5.40","118375724","1495776392640"
"348370","����","52600","83100","30500","57.98","84830812","5961655318500"
"058450","������Ʈ����","9154","3210","-5944","-64.93","178147830","191565493947"
"069410","���ڽ�","4935","5300","365","7.40","135370066","899167411810"
"227950","������","719","628","-91","-12.66","730732716","986202262843"
"291230","����","5490","3340","-2150","-39.16","463274089","2732665751121"
"198080","���ǵ�","1940","2200","260","13.40","66284236","168137105546"
"048830","��������","1775","1851","76","4.28","22642947","44341121841"
"096870","����Ƽ","3460","3040","-420","-12.14","8574738","30830668660"
"290650","���ؾ����̿�","23100","29150","6050","26.19","53876027","1708076266800"
"066970","���ؿ���","173500","205500","32000","18.44","226452114","55164079011176"
"156100","�������̹��̿�","7212","10200","2988","41.43","43967642","361541554580"
"073110","��������","6660","8220","1560","23.42","37802539","304840526510"
"083310","����Ƽ��Ũ","11300","20950","9650","85.40","78217066","1714832791950"
"037950","������","1030","1280","250","24.27","2651516504","4559926600128"
"170920","��Ƽ��","10000","15120","5120","51.20","58838212","734152439840"
"058630","������","7360","6250","-1110","-15.08","89005081","733757821630"
"058970","����","13150","72000","58850","447.53","90684590","5136273729930"
"019590","����ó����","1375","834","-541","-39.35","318526548","284772650445"
"169330","���극��","2790","3075","285","10.22","26009744","91514116750"
"179290","��������","11100","6860","-4240","-38.20","65927998","755185243530"
"009780","��������","6200","5260","-940","-15.16","48586372","340977000345"
"123040","������������","4205","5300","1095","26.04","80154140","442148115920"
"323230","���������ڸ���","834","2680","1846","221.34","141324632","241221086643"
"032790","�����ַ��","2015","1439","-576","-28.59","165143185","438856691719"
"033160","����������","11200","12770","1570","14.02","125159254","1877760782830"
"347890","��������","7970","7640","-330","-4.14","53375403","500726137500"
"033310","������","4620","3365","-1255","-27.16","43234477","187330119325"
"259630","���÷���","9640","11630","1990","20.64","64592437","860205844300"
"115960","����","18250","14940","-3310","-18.14","16698699","292881381830"
"060850","����������Ʈ��","9040","9000","-40","-0.44","9366475","90715415360"
"143540","����𿡽���","1245","1030","-215","-17.27","105039574","144889182442"
"036560","��ǳ����","11900","12250","350","2.94","58669284","783583863340"
"265560","��ȭ��ũ","8950","10400","1450","16.20","23325313","269425693110"
"036000","������","1810","1800","-10","-0.55","8442767","16885024443"
"250930","������ũ","1115","755","-360","-32.29","56868350","60402547230"
"053280","����24","4940","4805","-135","-2.73","55665406","306997702770"
"122640","����Ƽ","7200","16920","9720","135.00","48317317","742211631220"
"900300","������Ƽ�ڽ���ƽ","254","128","-126","-49.61","2151468170","464470743513"
"045060","����","3260","3125","-135","-4.14","7385366","23715536340"
"080520","������","4385","4935","550","12.54","55096657","295836120220"
"039830","���ζ�","8070","7280","-790","-9.79","5205535","39109658270"
"322310","���ν���ũ�����","13250","30250","17000","128.30","56393052","1239776640720"
"046120","��������","4380","3465","-915","-20.89","240755899","1188914336940"
"014940","������Ż����","2295","2925","630","27.45","37315622","126344949465"
"065500","������Ʈ����","1235","1347","112","9.07","90930152","135662290375"
"010470","������","15400","10480","-4920","-31.95","57270763","850943152890"
"352910","�����","9460","10450","990","10.47","33665639","393744541230"
"053980","�������̿�","4589","5520","931","20.29","75823861","472279442525"
"052420","����÷�ܼ���","1630","1580","-50","-3.07","239669183","434112892349"
"241790","���Ǻ긴��","13300","13080","-220","-1.65","18388771","267258027250"
"039200","��������","17300","23000","5700","32.95","97915477","2399225286490"
"226400","�����׿���","3165","5160","1995","63.03","117808563","627259517290"
"031510","������","1415","1979","564","39.86","51525601","94585948481"
"368970","��������","5320","5900","580","10.90","43368286","292135589580"
"138080","���ַ̼��","17600","13050","-4550","-25.85","21052455","355161416450"
"080580","��Ų������","18400","10250","-8150","-44.29","73359589","569061348295"
"067170","����","5630","4475","-1155","-20.52","23771400","138710249920"
"353590","�����","12550","7680","-4870","-38.80","28828420","323743724580"
"173130","���Ľ���","7736","11520","3784","48.91","180400226","2503188696070"
"049480","���º��̽�","2690","2650","-40","-1.49","322689980","1105283059135"
"394280","���¿�����ũ�����","7410","27000","19590","264.37","469881257","9271968485979"
"309930","�����Ӿ����۴�","2430","4605","2175","89.51","76292514","335237989260"
"244460","�ø��н�","6090","774","-5316","-87.29","225462425","449996150835"
"226950","�ø���","20350","15190","-5160","-25.36","31015624","635466523250"
"057540","�ȴϽý���","1414","921","-493","-34.87","107286334","149354542631"
"131030","����������","6290","5310","-980","-15.58","42916702","260404204650"
"082210","��Ʈ����","3665","3795","130","3.55","62627861","215013982545"
"109080","��Ƽ�ý�","11800","10590","-1210","-10.25","19909762","270458652060"
"380540","��Ƽ�ھ�","2300","1335","-965","-41.96","535142947","1498214068535"
"153710","��Ƽ��","7010","7030","20","0.29","18340693","145124371580"
"321820","���̴��÷���","5440","22400","16960","311.76","61132032","934909869910"
"122990","���̼�","6710","7780","1070","15.95","13577924","95061032090"
"112290","���̾���","11450","11760","310","2.71","35578962","471693197800"
"232140","���̾�������","2805","5470","2665","95.01","233221990","1057984399290"
"065530","���̾��","2160","1855","-305","-14.12","124829399","330348701213"
"067900","���̿���","8440","7360","-1080","-12.80","26892404","244357712940"
"007530","���̿�","2755","2770","15","0.54","26296087","99176010695"
"155650","���̿���","5650","5710","60","1.06","58643443","403729058070"
"273640","���̿���","19600","15520","-4080","-20.82","25737366","539440688310"
"251370","���̿�Ƽ","13900","10740","-3160","-22.73","6759250","83604760390"
"066430","���̿���","1155","724","-431","-37.32","132319483","140582304489"
"193250","�������̿�������","1240","842","-398","-32.10","65527784","75423708236"
"273060","���������","1250","1593","343","27.44","761746605","1259241205716"
"019210","������-��","6380","5750","-630","-9.87","36010993","232107575820"
"122870","�������������θ�Ʈ","43850","47550","3700","8.44","129377325","8633023512350"
"332570","������","2900","2945","45","1.55","150552116","603389209945"
"079000","���佺�ڸ���","5290","4940","-350","-6.62","2311192","12325240020"
"032820","�츮���","1295","1297","2","0.15","854337383","1324676187279"
"041190","�츮�������","3750","6810","3060","81.60","588747946","3122618339915"
"115440","�츮��","8350","7340","-1010","-12.10","115678585","1105159905620"
"046970","�츮��","1155","1774","619","53.59","1321537834","2759235908919"
"082850","�츮���̿�","3000","3530","530","17.67","395145373","1139836861674"
"215360","�츮���","13150","14020","870","6.62","16367030","295515658930"
"072470","�츮���Ȧ����","4265","3490","-775","-18.17","24597843","111106535780"
"073560","�츮�տ�������","1795","1545","-250","-13.93","102737446","190920188819"
"037400","�츮������������","1780","1795","15","0.84","18161232","30036624148"
"153490","�츮�̾ؿ�","1010","1071","61","6.04","230320533","274045914236"
"101170","�츲��Ƽ����","5810","6430","620","10.67","147829814","1101089567810"
"066590","���AMS","2380","2755","375","15.76","139289759","451689254390"
"103840","���","2605","4815","2210","84.84","221071768","1041610378230"
"046940","�������","3280","3185","-95","-2.90","54168101","185929643805"
"215380","�������̿�","2985","2150","-835","-27.97","31550102","93938394019"
"065680","�����Ϸ�Ʈ��","13550","15780","2230","16.46","14837327","213632087170"
"018620","���������","1540","1245","-295","-19.16","120982721","188971325774"
"307280","�����̿���","1670","1768","98","5.87","162456288","345108211994"
"032940","����","3960","3700","-260","-6.57","10319814","39985391720"
"240810","����IPS","24750","34850","10100","40.81","75811922","2468509331100"
"074600","����QnC","23400","32200","8800","37.61","74061984","1977154721400"
"104830","���͸�Ʈ������","28400","31900","3500","12.32","17346591","491537101175"
"014190","����ť��","2025","2660","635","31.36","187134823","458131605508"
"217820","�����Ǿ���","7296","6220","-1076","-14.75","504604269","5466171488980"
"030530","����Ȧ����","3395","3455","60","1.77","52900151","186564028870"
"012620","����Ư��","9390","8780","-610","-6.50","2443287","23571488100"
"382840","����","16500","18400","1900","11.52","93315051","2345791591890"
"336570","����","4645","9270","4625","99.57","358081211","3068667764915"
"376980","��Ƽ�左","12550","11230","-1320","-10.52","29427795","376657309310"
"008370","��ǳ","4965","4335","-630","-12.69","12344094","56517421670"
"008290","��ǳ����","963","737","-226","-23.47","138877130","139997372565"
"101160","������","18600","26800","8200","44.09","43952395","1095113644970"
"064090","����Ʈ������","1815","1923","108","5.95","45999975","91853354302"
"336060","���̹���","1510","1539","29","1.92","791613330","1572956428115"
"095270","���̺��Ϸ�Ʈ��","4220","5090","870","20.62","13813060","80739489520"
"065950","��ũ��","3090","3160","70","2.27","237841826","787356923465"
"076080","��ũ������","4840","3440","-1400","-28.93","299896633","1618923836085"
"043590","��ŵ��������","1060","1064","4","0.38","92694363","133815166059"
"196700","����","3400","1910","-1490","-43.82","54689557","167952123210"
"069080","����","15250","16390","1140","7.48","22438497","364277270370"
"053580","���ɽ�","14500","9400","-5100","-35.17","7147655","97839429830"
"071460","���Ͼ�","2345","613","-1732","-73.86","370011333","414781377316"
"377460","���Ͼƿ��̵�","6300","1691","-4609","-73.16","280047751","542688664313"
"044340","���н�","11200","10680","-520","-4.64","10048079","115892568410"
"330350","����������","9370","9810","440","4.70","177601411","1885870782050"
"348350","������","11250","10460","-790","-7.02","26330054","431861082070"
"112040","�����̵�","31550","61100","29550","93.66","238571196","11979406315300"
"101730","�����̵�ƽ�","9580","14190","4610","48.12","174539475","2597990636590"
"123420","�����̵��÷���","12400","12580","180","1.45","95874320","1336895518110"
"065370","����������","11000","8220","-2780","-25.27","50955039","945373148510"
"038620","��������","791","799","8","1.01","111279749","99791992450"
"299900","��������Ʃ���","4313","3880","-433","-10.04","403370388","1946085635205"
"036090","����Ʈ","621","850","229","36.88","1053818216","921893529541"
"136540","����","12700","12060","-640","-5.04","8587470","115753939900"
"320000","����","2265","2165","-100","-4.42","480644658","2241294124025"
"097800","����","1195","1710","515","43.10","268894083","481691631924"
"192390","��������","3250","4280","1030","31.69","25878012","99861126280"
"313760","������","6810","6800","-10","-0.15","28572652","309041686460"
"335870","����ǲ","3135","1669","-1466","-46.76","22994660","51300048608"
"900340","����Ǫ��","1010","787","-223","-22.08","212278017","247873885488"
"036200","���ϼ�","5620","8700","3080","54.80","95187435","814319732650"
"018000","���Ͻ�","1625","1339","-286","-17.60","330574341","692084184475"
"203450","���Ͽ�Ŀ�´�Ƽ","3085","3370","285","9.24","115401907","456349886495"
"011320","����ũ","4620","5220","600","12.99","93162434","574893928750"
"086390","�����׽�Ʈ","10500","13670","3170","30.19","48022954","640226715210"
"241690","������ũ��","3500","4155","655","18.71","65879374","291275805855"
"142210","����Ʈ����","3775","4300","525","13.91","86114153","390671424900"
"048430","������ũ","7590","8420","830","10.94","118579121","1246714093020"
"206650","�����̿�������","8900","11030","2130","23.93","101926339","929159817550"
"089850","���񺧷Ͻ�","11800","16680","4880","41.36","18450770","274368274220"
"084440","�����","1215","1615","400","32.92","279971371","555751124327"
"032620","�����ɾ�","5040","4760","-280","-5.56","91601189","574098514790"
"264450","��������","14700","15940","1240","8.44","7448356","112941246770"
"078070","��������Ȧ����","16450","12860","-3590","-21.82","1901505","25680799210"
"024800","����Ƽ������","2360","2200","-160","-6.78","9258378","21136605412"
"054930","����","32200","33000","800","2.48","42583130","1654892543950"
"069330","�����̵�","1720","1642","-78","-4.53","49767436","85754567674"
"049520","�����̿�","3305","5380","2075","62.78","41046729","204332343305"
"435380","����Ÿ��10ȣ����","2000","2065","65","3.25","3437824","7122543675"
"430700","����Ÿ��9ȣ����","2015","2095","80","3.97","3465880","7310535790"
"263770","������Ƽ","3120","3085","-35","-1.12","23158223","93620591465"
"388720","���Ϸκ�ƽ��","21100","27450","6350","30.09","100944396","2942468797470"
"340930","���Ͽ�����ũ","16150","11520","-4630","-28.67","57337807","1221840714520"
"023410","�������","3595","3430","-165","-4.59","126593399","489688923555"
"056080","�����κ�","3880","11380","7500","193.30","634515670","6415850265610"
"388800","��������7ȣ","2040","2440","400","19.61","2494920","5619111360"
"413630","��������8ȣ","2015","2470","455","22.58","3392086","7418431175"
"442130","��������9ȣ","2040","2235","195","9.56","3591695","8165332067"
"084370","������ũ","22150","41250","19100","86.23","61260231","2119459053500"
"179900","��Ƽ����","25800","38850","13050","50.58","18358923","483665982920"
"263050","��ƿ����","6640","3465","-3175","-47.82","75862577","351449005605"
"191410","���Ͼ�������","2915","2500","-415","-14.24","40206684","155387172990"
"372170","���������ؾ�","44400","108200","63800","143.69","45739487","5971938128100"
"072770","��ȣ","1355","2820","1465","108.12","304177889","820700353999"
"039020","�̰�Ȧ����","3230","2820","-410","-12.69","22305487","71498376610"
"067920","�̱۷�","5710","6280","570","9.98","68068689","537904319460"
"044960","�̱ۺ�","5460","5520","60","1.10","130441111","814502272175"
"303530","�̳뵪","12400","11000","-1400","-11.29","31254327","476740668750"
"296640","�̳�꽺","9610","7220","-2390","-24.87","53199572","713139648683"
"302430","�̳��Ʈ��","12850","11480","-1370","-10.66","12178522","173103764330"
"056090","�̳�ý�","1180","1180","0","0.00","0","0"
"073490","�̳���̾��","34000","26850","-7150","-21.03","11104752","302416130350"
"215790","�̳��ν�Ʈ���Ʈ","1255","1094","-161","-12.83","283845344","527944156114"
"246960","�̳��׶���","8560","8860","300","3.50","5450334","46309279390"
"088390","�̳콺","22000","23450","1450","6.59","35466810","1308767489750"
"272290","�̳콺÷�ܼ���","30300","32200","1900","6.27","84415743","3329550255300"
"053350","�̴���","3530","3250","-280","-7.93","25025937","118446224225"
"041520","�̶�����","5050","7150","2100","41.58","23971350","194720177205"
"264850","�̷��ý�","2400","4185","1785","74.38","565249551","2496804319265"
"054210","�̷���","11300","10070","-1230","-10.88","75372309","1004585958570"
"164060","�̷��","6300","6990","690","10.95","202048378","1695742688480"
"065440","�̷��","2480","1842","-638","-25.73","237138997","634890400644"
"115610","�̹�����","1780","4060","2280","128.09","347400701","1242831763643"
"078020","�̺���Ʈ��������","5000","3860","-1140","-22.80","12787979","56798786270"
"131400","�̺���÷�ܼ���","1646","3705","2059","125.09","2101249866","13237342795071"
"351330","�̻迣���Ͼ","7930","8760","830","10.47","51372828","575746416450"
"080010","�̻��Ʈ����","5180","5270","90","1.74","19460768","114690117730"
"086890","�̼�������","5750","6200","450","7.83","72672447","509556742570"
"047560","�̽�Ʈ����Ʈ","8800","15610","6810","77.39","152237477","2315621331750"
"900110","�̽�Ʈ�ƽþ�Ȧ����","174","123","-51","-29.31","1480709746","235082052591"
"067010","�̾�����","3435","3510","75","2.18","25263314","99571314615"
"102710","�̿�������ũ�����","20200","27050","6850","33.91","18506317","419586247830"
"063760","�̿���","3420","3490","70","2.05","42514360","193660840880"
"123570","�̿���","4080","3685","-395","-9.68","125865124","526371318550"
"083470","�̿��ؾ���","5210","1660","-3550","-68.14","148466670","518949109252"
"095190","�̿��ڸ���","3020","2260","-760","-25.17","48398913","137526944005"
"091120","�̿���","21550","42050","20500","95.13","55411496","2111027585350"
"039030","�̿���ũ�н�","66600","152600","86000","129.13","43148096","5583822705200"
"294090","�̿��÷ο�","15000","4490","-10510","-70.07","203627117","3791886824970"
"088290","�̿�������","7070","1810","-5260","-74.40","103892662","483161077431"
"181340","����̵��","2705","2705","0","0.00","0","0"
"353810","�������̿�","4025","3595","-430","-10.68","72071011","295457114170"
"099750","�����ɾ���","19600","19190","-410","-2.09","21975268","575594297130"
"377330","����Ʈ�δн�","9960","8170","-1790","-17.97","19656948","233169174910"
"035810","����Ȧ����","2810","3105","295","10.50","63836893","198200021285"
"160600","��ť��","3100","3100","0","0.00","0","0"
"092130","��ũ������","16050","13810","-2240","-13.96","1940037","29988830110"
"096040","��Ʈ��","146","271","125","85.62","4917520883","1433552841499"
"134060","��ǻ��","5650","5430","-220","-3.89","4004400","24819826615"
"001840","��ȭ����","3835","3285","-550","-14.34","79993494","347244546985"
"024810","��ȭ����","638","899","261","40.91","1672985200","1906243893621"
"041830","�ιٵ�","20200","26650","6450","31.93","17081025","451104912225"
"352940","�ι��̿�","4265","3555","-710","-16.65","57391284","290873045075"
"079950","�κ��Ͼ�","1485","1140","-345","-23.23","129327579","248065144671"
"389470","�κ�Ƽ����","9780","18000","8220","84.05","199776352","3808029454370"
"277410","�λ갡","1780","1906","126","7.08","906026735","2706509618193"
"060150","�μ��̿�Ƽ","8270","7460","-810","-9.79","74986924","647978303335"
"033230","�μ�����","2130","3120","990","46.48","1016240748","3521626073570"
"037330","�������÷�","1645","1848","203","12.34","172571331","475621871363"
"100030","��������Ʈ","17800","17150","-650","-3.65","4982589","111121286630"
"211050","��ī��������","6740","16750","10010","148.52","20854161","229544143150"
"083640","����","1095","559","-536","-48.95","237770534","208118609710"
"216050","��ũ�ν�","15200","10670","-4530","-29.80","32686745","493232775192"
"049070","��ž��","27750","27150","-600","-2.16","107988449","3734226183800"
"119610","���ͷ���","28200","31900","3700","13.12","18393294","605241845475"
"017250","���Ϳ�","1160","1278","118","10.17","23205444","33513966783"
"051370","�����÷���","9130","11150","2020","22.12","30787157","345593339840"
"064290","�����÷���","13750","30950","17200","125.09","62477989","1990334201490"
"189300","���ڸ�����ũ","65830","75100","9270","14.08","33509822","2611239817000"
"150840","��Ʈ�θ޵�","5850","5850","0","0.00","0","0"
"048530","��Ʈ�й��̿�","8130","9070","940","11.56","254167087","2283945830830"
"175140","������ũ","5630","3380","-2250","-39.96","28965838","196177135365"
"115310","��������","21300","21050","-250","-1.17","3793102","96798069750"
"039290","������ũ","9560","11670","2110","22.07","75943596","1166410246920"
"071200","���Ǵ�Ʈ�ｺ�ɾ�","5490","5260","-230","-4.19","61366004","364688618365"
"101930","��ȭ����","12600","11380","-1220","-9.68","6737223","78024773340"
"333430","�Ͻ�","3070","2815","-255","-8.31","288358097","1194279599110"
"068330","�ϽŹ��̿�","1555","1375","-180","-11.58","41985150","77398224692"
"178780","�Ͽ�������","8650","8650","0","0.00","0","0"
"019540","������ũ","2450","3945","1495","61.02","34873399","147023863105"
"094820","�����Ŀ�","12000","11650","-350","-2.92","94749448","1334976508070"
"950140","�ױۿ�左","5090","13120","8030","157.76","104767928","931756346665"
"049550","��ũ��ũ","4905","4135","-770","-15.70","10339690","52275375105"
"254120","�ں�","1491","2315","824","55.26","292060303","1038655610281"
"043910","�ڿ���ȯ��","1010","1064","54","5.35","840166986","1154021030196"
"234920","���̱�","5440","6950","1510","27.76","144960840","2788393349975"
"289220","���̾�Ʈ����","17450","12250","-5200","-29.80","57339913","1101406145000"
"174880","�����ũ","4390","2650","-1740","-39.64","18306021","12753258331"
"049630","�翵�ַ���","543","620","77","14.18","134352556","93193017159"
"417840","������","7510","13120","5610","74.70","114278016","1704736416950"
"110020","�������̿���","3740","8070","4330","115.78","39941529","273018629890"
"208140","���ٿ�","2135","2750","615","28.81","66486255","168054331035"
"040420","�������̿�����","7140","6980","-160","-2.24","3255183","23449056290"
"045510","�������ý�","1290","1329","39","3.02","16488560","24096836348"
"217190","���ʼ�","5100","13690","8590","168.43","22482818","256680728920"
"095700","���ؽ�","14407","10330","-4077","-28.30","93138794","1094327459810"
"072520","���ٹ��̿�","1910","415","-1495","-78.27","257694394","270220134586"
"122310","���뷹��","7740","6990","-750","-9.69","19903189","149643378390"
"361390","������","19950","17310","-2640","-13.23","17680205","384526214690"
"187420","������Ŀ��","5450","4085","-1365","-25.05","31583036","152995808040"
"225220","������","4660","3855","-805","-17.27","28639420","227199002090"
"123330","����","4400","3670","-730","-16.59","9966366","44980398455"
"159580","����������","6870","6850","-20","-0.29","69456266","503033760355"
"147830","������","3200","3630","430","13.44","112105477","484700230670"
"033100","��������","11250","20400","9150","81.33","93661783","1668622638910"
"079370","���콺","25750","50500","24750","96.12","85018637","3314231329400"
"054950","���̺��̿�","20450","26600","6150","30.07","30240031","842722614260"
"023440","���̽���Ȧ����","2710","1430","-1280","-47.23","475677937","1478628098685"
"090470","���̽���","7720","9570","1850","23.96","55787714","544735403405"
"287410","���̽ý��޵�Į","8520","10530","2010","23.59","211893005","2257002775254"
"137950","���̾��ɹ�Į","6640","7270","630","9.49","70214032","550512920130"
"033320","���̾����ý���","5130","4875","-255","-4.97","355700667","1975283439200"
"417500","���̾�����ũ","2514","4220","1706","67.86","195550219","1495215230695"
"204270","���̾�Ƽ��","5890","12180","6290","106.79","60898210","641613419550"
"026040","���̿���Ƽ��","2465","2215","-250","-10.14","40839951","133864117615"
"126880","���̿���������","5140","5380","240","4.67","92197415","589589278550"
"322510","���̿�����","3150","20650","17500","555.56","150262686","3368100247370"
"033050","���̿�����","1160","1131","-29","-2.50","36659623","44824178712"
"094970","���̿�Ƽ","3085","4255","1170","37.93","43444105","164647751620"
"089790","����Ƽ","6810","8840","2030","29.81","44197279","406206377190"
"052670","���Ϲ��̿�","1245","2080","835","67.07","121715007","252926858868"
"199820","�����������","9470","9970","500","5.28","37926467","513665866780"
"038010","������ũ�뽺","6810","8480","1670","24.52","65837278","558506987870"
"276730","���ָ���","1320","989","-331","-25.08","187241716","274210308360"
"080220","���ֹݵ�ü","3580","16700","13120","366.48","758948576","5594583396685"
"216080","���׸�","13100","16640","3540","27.02","23892295","502565204810"
"229000","��ť����","5706","6270","564","9.88","195241834","1109104440515"
"082270","���齺","11850","13930","2080","17.55","38136248","534921120750"
"064800","���齺��ũ","1325","1380","55","4.15","149592829","204856052697"
"044060","����ILI","1175","732","-443","-37.70","332997661","324495633741"
"034940","��������","2355","2000","-355","-15.07","34749711","76286166763"
"067000","���̽�Ƽ","4040","2845","-1195","-29.58","193239265","846227317855"
"033340","���������","2110","2110","0","0.00","0","0"
"036930","�ּ������Ͼ","10600","33400","22800","215.09","476325405","10348819363730"
"239340","�����ͳ�","3145","2985","-160","-5.09","391980055","1666571602620"
"072020","�߾ӹ��","11000","11000","0","0.00","68908381","879588390150"
"000440","�߾ӿ��ʺ�","19500","17330","-2170","-11.13","46979786","1063133566840"
"051980","�߾�÷�ܼ���","1320","2225","905","68.56","295671834","821313540329"
"228760","�����Ʈ��","8790","23450","14660","166.78","158432751","2988614311490"
"314130","��������۴�","17450","13490","-3960","-22.69","32545011","667943573980"
"389030","���ϳʽ�","2145","2585","440","20.51","394615512","1637366592770"
"043610","���Ϲ���","3410","3440","30","0.88","163284017","666128657255"
"263860","���Ͼ�","8220","12780","4560","55.47","20257297","253826582950"
"303030","����ƽ��","1340","1598","258","19.25","198788969","367270179700"
"036180","��������������","729","638","-91","-12.48","327818787","249521572431"
"208350","����������ť��Ƽ","4125","4280","155","3.76","9384888","41860608130"
"144510","������","47150","45500","-1650","-3.50","18592156","750769902750"
"382480","��������","3160","3235","75","2.37","313689393","1442169393505"
"382800","���غ񿡽� ����","2775","5650","2875","103.60","46238900","744919601690"
"051160","�������Ʈ","9200","9800","600","6.52","95763997","932090747670"
"053050","��������","3815","3365","-450","-11.80","795006720","3494005300930"
"119850","������������","3575","4315","740","20.70","202275373","1083472183480"
"065060","������","397","522","125","31.49","150029612","71183247489"
"204840","��������","750","1220","470","62.67","219203813","229731129879"
"270520","������������","1186","2170","984","82.97","975956886","9299928421870"
"311320","����������Ʈ","9822","12720","2898","29.51","43876463","539637360080"
"388050","�����Ŀ�","8210","8130","-80","-0.97","421696083","4750292965060"
"219750","��Ƽ�����Ͻ�","2850","2850","0","0.00","0","0"
"018120","���ι�ȿ","20950","15870","-5080","-24.25","1018573","17559300700"
"109820","����Ʈ����","4055","3155","-900","-22.19","115471263","572157019895"
"086060","�����̿���","3990","4400","410","10.28","63003045","289792843105"
"036890","����Ƽ�̾�","13150","10450","-2700","-20.53","126210290","1590032191190"
"363250","���ý���","8370","9000","630","7.53","61237747","930230593140"
"007370","��������","6520","6340","-180","-2.76","8057455","49980891160"
"085660","�����̿���","13000","19760","6760","52.00","114360578","1908046694970"
"261780","����ſ�����","4985","5660","675","13.54","113570981","669217779585"
"094850","����������","11000","7050","-3950","-35.91","16513611","160806192030"
"004650","â�ؿ�ź��","10750","9590","-1160","-10.79","13994316","162524680320"
"278280","õ��","218300","109700","-108600","-49.75","24690049","5020488763350"
"362320","û��۷ι�","11000","7930","-3070","-27.91","188139239","2008112068510"
"066360","ü���η�","1080","1365","285","26.39","93958068","143761254904"
"047820","�ʷϹ�̵��","10650","5400","-5250","-49.30","17007347","151975260890"
"094360","Ĩ���ع̵��","7050","34350","27300","387.23","193697928","6018479558737"
"016790","ī�����ƹ��̿�","4135","5290","1155","27.93","1120077294","18523999550490"
"016920","ī��","1650","1540","-110","-6.67","33104227","52665038287"
"284620","ī�̳뽺�޵�","4100","4385","285","6.95","52391780","272500559760"
"293490","īī��������","44650","26150","-18500","-41.43","117531102","4251453015900"
"042000","ī��24","9860","28000","18140","183.98","138127337","2610833903950"
"317530","ĳ������Ʈ","7330","5370","-1960","-26.74","62737996","535852846455"
"071850","ĳ�����ڸ���","2085","2350","265","12.71","19481215","45669032778"
"050110","ķ�ý�","1755","1438","-317","-18.06","426508974","787365278022"
"119860","Ŀ��Ʈ���̺�","15400","16380","980","6.36","28077606","391623801920"
"223310","Ŀ�ӽ����̳�","3500","1690","-1810","-51.71","16968679","40138332902"
"900310","�÷�����","1205","910","-295","-24.48","545084655","714164225097"
"078340","������","59600","48200","-11400","-19.13","36935286","2374305697200"
"063080","������Ȧ����","38750","37500","-1250","-3.23","27397395","1191337779850"
"307930","���۴�����","5470","6830","1360","24.86","155985338","1161606089025"
"079190","�ɽ��ǿ�","1175","920","-255","-21.70","252118915","307590697077"
"263700","�ɾ��","6610","4425","-2185","-33.06","59261894","451581017970"
"214370","�ɾ���","27420","27850","430","1.57","31224749","2826393882900"
"221980","���̵���","13200","12360","-840","-6.36","2255266","31134923620"
"038530","���̹��̿�","600","287","-313","-52.17","592481925","274626485105"
"424140","���̺���21ȣ����","1980","2015","35","1.77","4673857","9521892559"
"436530","���̺���22ȣ����","2337","2915","578","24.73","6556913","16348551440"
"192250","���̻���","1590","1316","-274","-17.23","237873068","413656562320"
"115500","���̾�����","5240","7180","1940","37.02","186306446","1683367569915"
"089150","���̾�Ƽ","3220","2935","-285","-8.85","73830185","283522567140"
"025880","���̾��ǵ�","2555","2500","-55","-2.15","57141310","161053514500"
"093320","���̾��̿�����","54600","95700","41100","75.27","10789056","800834937412"
"093640","���̾˿�","4735","8870","4135","87.33","282191068","2709052969565"
"073010","���̿�����","1750","2950","1200","68.57","95288053","247676095879"
"105330","���̿�������","8100","8820","720","8.89","35191447","407088191460"
"053080","���̿���","8580","17000","8420","98.14","67953900","1223669444470"
"272110","���̿�����","12850","20600","7750","60.31","32678417","645494089800"
"039420","���̿���","2470","2660","190","7.69","49729806","134380457750"
"083550","���̿�","5817","4930","-887","-15.25","11564589","63722479540"
"032500","���̿�������","26500","12700","-13800","-52.08","81057017","1269171411930"
"225430","���̿�����","1590","987","-603","-37.92","41303530","59035276198"
"102370","���̿���","4605","6120","1515","32.90","188956012","1207539939995"
"036030","����Ƽ����","5430","6050","620","11.42","134771367","1018757881710"
"064820","������","4430","4235","-195","-4.40","19867213","86739939700"
"256940","�����ǿ���","6820","6270","-550","-8.06","42267476","423328825590"
"024880","�����ǿ���","5090","5000","-90","-1.77","137476586","885608716850"
"042040","�����ǿ���ũ","347","406","59","17.00","542345064","318107893128"
"054410","������Ƽ��","5060","5050","-10","-0.20","9168942","55765083470"
"258610","���Ϸ�","3600","4095","495","13.75","55547667","202581750250"
"274090","���ھƿ���ν����̽�","12100","13480","1380","11.40","62286830","987253502766"
"089010","��Ʈ�δн�","13250","24400","11150","84.15","51933282","1214903612530"
"220260","��Ʈ�ν�","6970","7270","300","4.30","180453928","1837103890500"
"052400","�ڳ�����","16300","18360","2060","12.64","16472403","300402242240"
"402030","�ڳ���ũ�����","14125","33050","18925","133.98","84942146","6585055034650"
"391710","�ڴп�����̼�","3855","2645","-1210","-31.39","354605733","1622388809200"
"046070","�ڴ���","1045","420","-625","-59.81","240199813","134104741425"
"047770","�ڵ����Ĺ���","1745","1794","49","2.81","173195110","431109717828"
"080530","�ڵ�","1340","1409","69","5.15","47679345","69151145166"
"104540","�ڷ���","10800","12200","1400","12.96","13750126","166725699330"
"027050","�ڸ��Ƴ�","3410","2865","-545","-15.98","364054974","1452661237010"
"190650","�ڸ��ƿ�����������","7420","6170","-1250","-16.85","11172681","100445949400"
"123410","�ڸ��ƿ���Ƽ","2385","3700","1315","55.14","172668353","596991031340"
"036690","�ڸƽ�","2995","3320","325","10.85","178170086","737659295720"
"049430","�ڸ޷�","9920","9150","-770","-7.76","5242291","48910392540"
"183300","�ڹ���","43100","68200","25100","58.24","15171540","812550543269"
"041960","�ڹ���","6357","4230","-2127","-33.46","43703427","273204175022"
"089890","�ڼ���","10100","11780","1680","16.63","134665060","1732386122770"
"009730","�ڼ�","1370","2900","1530","111.68","110481811","457005122635"
"082660","�ڽ�����","603","415","-188","-31.18","1151584012","1278271476922"
"222040","�ڽ��ƽ�����Ƽ","4290","6400","2110","49.18","19381623","111975113770"
"241710","�ڽ���ī�ڸ���","10250","36350","26100","254.63","80217511","1702033407150"
"355150","�ڽ��ؽý�","2170","2290","120","5.53","275741871","906758240446"
"166480","�ھƽ����Ϳ�","7770","6760","-1010","-13.00","16034403","117230740148"
"045970","�ھƽþ�","4855","7570","2715","55.92","235716270","2249770640615"
"196450","�ھƽþƾ���","1445","1358","-87","-6.02","86016164","194386741316"
"029960","�ڿ���","7620","6890","-730","-9.58","32254759","233214665910"
"102940","�ڿ��ջ�������","27400","26350","-1050","-3.83","3273581","101018163950"
"950160","�ڿ���Ƽ����","8890","9430","540","6.07","23594266","228096259580"
"033290","�����м�","4405","5730","1325","30.08","169520739","1127451001890"
"056360","������","6980","6000","-980","-14.04","75831722","576114386340"
"282880","������ũ","22348","27750","5402","24.17","66355870","2282718794450"
"121850","������","2730","1529","-1201","-43.99","540823264","1462980595040"
"015710","����","6550","4855","-1695","-25.88","231378071","1534750288795"
"052330","����","9100","6800","-2300","-25.27","15466588","142383344120"
"322780","���۽��ڸ���","2745","1957","-788","-28.71","133156612","394656238950"
"200130","�ݸ���ؿ���ġ","28300","17740","-10560","-37.31","24311664","531512095580"
"294570","����","32750","19950","-12800","-39.08","13857928","380038792040"
"317690","��Ÿ��Ʈ����","4620","4680","60","1.30","46928407","280534481300"
"078940","��Ÿ�Ǿ�","1130","2855","1725","152.65","268296338","678535476886"
"365270","ť��Ŭ","11350","11900","550","4.85","40633487","489762566720"
"060280","ť����","6720","18590","11870","176.64","436384621","7671834607100"
"040350","ť����","666","505","-161","-24.17","246706942","143114077470"
"051780","ť��Ȧ����","411","357","-54","-13.14","318627084","135185978493"
"115180","ť����Ʈ","7378","3955","-3423","-46.39","53266787","341651835820"
"182360","ť�꿣��","16200","19130","2930","18.09","77592171","1658351946260"
"405100","ť��Ƽ","12000","16370","4370","36.42","38288303","523796659420"
"066310","ť��������","9430","10190","760","8.06","32250159","348013801070"
"016600","ťĳ��Ż","388","358","-30","-7.73","159558366","63443143158"
"096240","ũ������","18150","16510","-1640","-9.04","14553855","264554784590"
"114120","ũ�����","10850","10850","0","0.00","0","0"
"110790","ũ���������ؾ�","10300","8450","-1850","-17.96","5845201","102110447030"
"900250","ũ����Ż�ż���","909","1551","642","70.63","2821327741","8121746748531"
"045520","ũ���ػ��̾�","9370","7980","-1390","-14.83","7559976","72409680070"
"036170","Ŭ���忡��","914","890","-24","-2.63","365463502","487547458270"
"214150","Ŭ���ý�","18400","37650","19250","104.62","89369624","2631417076937"
"352770","Ŭ����ͽ�","3878","2625","-1253","-32.31","241807357","1115580632760"
"237880","Ŭ����","16200","30200","14000","86.42","37452635","870289446830"
"139670","Ű�׸�����","8570","4720","-3850","-44.92","35265603","285811650685"
"413600","Ű����6ȣ����","2010","2140","130","6.47","2037334","4343275350"
"433530","Ű����7ȣ����","2015","2090","75","3.72","1986464","4139088605"
"054780","Ű�̽�Ʈ","9350","7470","-1880","-20.11","78916030","775746261260"
"219130","Ÿ�̰��Ϸ�","20050","21750","1700","8.48","11632057","269685339900"
"360070","ž��Ƽ����","30350","59300","28950","95.39","48110760","2993750730400"
"065130","ž�����Ͼ","5140","5530","390","7.59","45024530","361863144295"
"134580","ž�ڹ̵��","4950","3475","-1475","-29.80","39478850","203464623870"
"023160","�±�","16100","14700","-1400","-8.70","51925921","920137884710"
"323280","�¼�","1720","4230","2510","145.93","612530950","1991555407545"
"053620","�¾�","7950","7470","-480","-6.04","1878068","14669398310"
"044490","�¿�","9800","16600","6800","69.39","28001661","463573996050"
"124560","�¿�������","4385","3505","-880","-20.07","56478453","243380507560"
"191420","�װ����̾�","12200","14660","2460","20.16","13056397","167056432930"
"073640","�׶���̾�","1860","1424","-436","-23.44","1746506414","5848424513532"
"066700","�׶������ؽ�","4420","4590","170","3.85","84508036","407863535890"
"095610","�׽�","15700","20750","5050","32.17","41753591","877387476090"
"064520","��ũ��","5680","3730","-1950","-34.33","24155929","157466799375"
"089030","��ũ��","5640","11630","5990","106.21","133798645","1135878902740"
"054450","�ڷ�Ĩ��","11050","33850","22800","206.33","223476342","5165196117640"
"091440","�ڷ��ʵ�","2015","11980","9965","494.54","181932032","688655022071"
"200230","����RF����","1015","880","-135","-13.30","187569392","220207059457"
"215480","��ڽ��ڸ���","4180","4015","-165","-3.95","21009703","87578287200"
"051360","���","9480","16750","7270","76.69","50320738","707497564230"
"045340","��Ż����Ʈ","3880","4785","905","23.32","19211687","89707957360"
"108230","����","6530","7730","1200","18.38","71172256","646050432600"
"079970","�������Ʈ","910","560","-350","-38.46","245327768","237423886529"
"199800","����","54900","67700","12800","23.32","15091159","830399474700"
"105550","Ʈ����","2190","2680","490","22.37","106151451","249159796566"
"290090","Ʈ��","15400","12790","-2610","-16.95","7520752","117860488280"
"026150","Ư���Ǽ�","7620","8070","450","5.91","45641986","375395994080"
"322180","Ƽ������","2293","4870","2577","112.39","67371835","804853948640"
"117730","Ƽ�κ�ƽ��","6000","18500","12500","208.33","321235341","6121977154910"
"033830","Ƽ��","1110","999","-111","-10.00","48532364","50161300106"
"057680","Ƽ���̾�Ƽ��","2480","1760","-720","-29.03","255128739","597373172353"
"204610","Ƽ����","1750","1261","-489","-27.94","830099731","1735063879307"
"064760","Ƽ������","94600","117300","22700","24.00","9760199","974267575285"
"246710","Ƽ�ؾ˹��̿���","11450","9060","-2390","-20.87","22173312","287360792920"
"340570","Ƽ�ؿ�","36200","38100","1900","5.25","18366364","863849754200"
"043220","Ƽ�����ؽ���","888","631","-257","-28.94","78062554","57973506193"
"277880","Ƽ��������","8900","9260","360","4.04","118736414","1560710194320"
"131290","Ƽ������","36950","51400","14450","39.11","34975374","1570765191700"
"425420","Ƽ������","7840","37100","29260","373.21","108902034","2023265335910"
"131100","Ƽ���������θ�Ʈ","2420","2255","-165","-6.82","69371807","208885108954"
"356860","Ƽ����","18800","32100","13300","70.74","69559002","1681786182110"
"062860","Ƽ������","5870","5800","-70","-1.19","231957","1375431130"
"321550","Ƽ����̿�","12600","9920","-2680","-21.27","21573390","215289522870"
"104480","Ƽ�����ɹ�Į","2830","1830","-1000","-35.34","156559621","386322738828"
"081150","Ƽ�÷���","3750","3265","-485","-12.93","321137321","1408014721685"
"130740","Ƽ�Ǿ��۷ι�","2895","2970","75","2.59","152556503","543486207360"
"084730","��ũ����","12700","16790","4090","32.20","26449271","395906693300"
"058530","�ĳ����̾�","1620","1620","0","0.00","0","0"
"034230","�Ķ���̽�","17600","13440","-4160","-23.64","218236091","3488862511710"
"033540","�Ķ���","791","1715","924","116.81","502963471","615410500820"
"043200","�ķ�","821","670","-151","-18.39","100239189","85804810084"
"214450","�ĸ�����ġ","69900","110600","40700","58.23","29221111","3306208046432"
"208340","�ĸ��","2975","3320","345","11.60","301495600","698800214590"
"177830","�Ĺ�����","3730","3490","-240","-6.43","79739823","368490524820"
"037070","�ļ���","13000","10160","-2840","-21.85","18757842","250001162920"
"150900","�ļ�","9100","9470","370","4.07","19916135","163300584540"
"037030","�Ŀ���","2865","3175","310","10.82","200538941","792377029985"
"047310","�Ŀ�������","4385","6650","2265","51.65","670133596","6777454287845"
"368770","���̹�����","2165","3445","1280","59.12","253532618","1024950696975"
"170790","���̿���ũ","12100","10790","-1310","-10.83","9440536","133440053000"
"049120","���ε�ؾ�","1600","1149","-451","-28.19","11823501","17543121812"
"038950","���ε�����","4485","4990","505","11.26","31249076","177350616555"
"441270","���ο���","6160","9250","3090","50.16","101686744","915848460040"
"106240","������ũ�н�","2010","1818","-192","-9.55","100779025","261361215098"
"131760","������","1160","948","-212","-18.28","94754690","116152513568"
"065690","��Ŀ��","2285","1526","-759","-33.22","18040330","33988078376"
"140860","��ũ�ý��۽�","113900","182600","68700","60.32","9570618","1538857477652"
"091700","��Ʈ��","8100","8270","170","2.10","66625527","559398411408"
"032800","��Ÿ����","504","296","-208","-41.27","404952161","187575137305"
"318010","�ʽ���","10900","8600","-2300","-21.10","2760934","26206198580"
"027710","�ʽ��丮","1640","1610","-30","-1.83","985508373","2094607582687"
"225590","�м��÷���","1655","1234","-421","-25.44","34459510","51175065171"
"054300","�ҽ�Ÿ������������","608","758","150","24.67","134831244","102294915157"
"068050","�ҿ������θ�Ʈ","5210","3820","-1390","-26.68","79586635","394452559415"
"222110","����","6500","6700","200","3.08","4743922","27864584385"
"263750","�޾��","41950","38600","-3350","-7.99","78806910","3733339177202"
"251970","�����ڸ���","16450","24400","7950","48.33","21848263","486703472650"
"168360","��Ʈ��","2780","9000","6220","223.74","181516003","2461777791090"
"087010","��Ʈ��","7650","37200","29550","386.27","204515284","6054897332090"
"119500","����Ż","3410","3785","375","11.00","60957366","231348496205"
"389140","��������","11200","8250","-2950","-26.34","98310805","1607231268550"
"009520","�����ڿ���","7990","28750","20760","259.82","1005814594","22480808752330"
"189690","���ÿ���","2232","2515","283","12.68","358137711","1200047573175"
"318020","����Ʈ�����","18100","18100","0","0.00","0","0"
"256630","����Ʈ�����Ͼ","1975","1624","-351","-17.77","17197424","35331908949"
"331380","��Ŀ������ġ������","1915","2125","210","10.97","157391672","416585024206"
"234100","���󸮽�����","1845","1840","-5","-0.27","355972977","806429733702"
"041020","���󸮽����ǽ�","1300","4430","3130","240.77","1705879621","7591139144282"
"114630","���󸮽����","808","666","-142","-17.57","497420876","454303486497"
"290720","Ǫ�峪��","10300","7940","-2360","-22.91","38571567","382940747230"
"005670","Ǫ����","5400","4825","-575","-10.65","11954865","69209817405"
"094940","Ǫ�����","6150","8780","2630","42.76","162452148","1536867376100"
"007330","Ǫ����������","12400","8510","-3890","-31.37","30996364","323497348570"
"093380","ǳ��","3580","3845","265","7.40","16274919","65081789650"
"023900","ǳ������","12050","12340","290","2.41","28449682","408806061630"
"371950","ǳ������","9670","6740","-2930","-30.30","27477132","284189832950"
"370090","ǻ��Ƽ��","18450","33900","15450","83.74","78269364","2401014580390"
"220100","ǻ����","9610","10970","1360","14.15","72696468","768876136290"
"035200","�����Ľ�Ʈ","3585","3715","130","3.63","15358312","56494416105"
"334970","������Ƽ�����̿�������","3020","4650","1630","53.97","196415279","866893200710"
"321260","������õ","2175","2715","540","24.83","510975381","1757358316435"
"053610","������","21200","46000","24800","116.98","68156745","3058983296700"
"377220","���ҹ��̿�","8370","6310","-2060","-24.61","50263497","408032603490"
"335810","�����������̿�","5930","4800","-1130","-19.06","6534294","40310059890"
"053160","��������","6780","14800","8020","118.29","10695263","100701939280"
"405000","�ö����","5700","4170","-1530","-26.84","100428906","694763736910"
"041590","�÷���ũ","1110","1064","-46","-4.14","180809715","207358550760"
"367000","�÷�Ƽ��","10050","8700","-1350","-13.43","28680797","459838881460"
"075130","�÷�Ƽ��","2380","2390","10","0.42","21583559","56764574055"
"237820","�÷��̵�","5140","6640","1500","29.18","107778426","735816838435"
"023770","�÷�������","6350","5630","-720","-11.34","21942572","149438836985"
"300080","�ø���","25700","31550","5850","22.76","46609438","1451295406840"
"032580","�ǵ�����","1280","1706","426","33.28","1290495010","2487058226540"
"051380","�Ǿ���Ʈ","3980","4395","415","10.43","66029146","504841050790"
"241820","�Ǿ���","4452","3785","-667","-14.98","80505122","333635953350"
"237750","�Ǿؾ���ũ","5160","5610","450","8.72","30178298","194276574895"
"319660","�ǿ�������","15400","21750","6350","41.23","89894166","1830744687500"
"031980","�ǿ�������Ȧ����","6850","27250","20400","297.81","87270011","1989577166857"
"002230","�ǿ�����","3760","3910","150","3.99","6039694","26034809885"
"057880","�ǿ���ġ��","1740","1740","0","0.00","0","0"
"043370","�ǿ���ġ����","7040","10090","3050","43.32","18245501","173674787790"
"239890","�ǿ�����ġ��ũ","15850","24500","8650","54.57","31945614","714494359000"
"347740","�ǿ������Ǻ��ӻ󿬱���Ÿ","3035","2490","-545","-17.96","91193768","313905513735"
"137400","�ǿ�Ƽ","43350","49450","6100","14.07","118539603","6925763988400"
"257370","�ǿ�Ƽ������","9210","9210","0","0.00","0","0"
"147760","�ǿ�Ƽ","4550","5250","700","15.38","14068298","72044430665"
"128660","�����̸�Ż","3290","3660","370","11.25","117456255","542206439050"
"006140","����������","5610","6730","1120","19.96","91916304","727076341240"
"376180","���ڱ׷�","5720","5450","-270","-4.72","348187479","3037792765820"
"304840","���ù��̿�","12076","3545","-8531","-70.64","88621645","1010634174000"
"062970","���Ǿ���","2500","2255","-245","-9.80","50459948","150088969405"
"087600","�ȼ��÷���","7690","9020","1330","17.30","37754000","308810841020"
"291810","����","6730","4025","-2705","-40.19","137841722","1158694705780"
"161580","�ʿ�ƽ��","7000","9210","2210","31.57","183598248","2348626535880"
"347770","�˽�","2750","3985","1235","44.91","35013432","332162047605"
"163730","�ΰ�","10650","13150","2500","23.47","66300237","932709708028"
"417180","�ΰŽ��丮","7360","3290","-4070","-55.30","242691392","2046912065600"
"406760","�ϳ�����21ȣ����","2020","2085","65","3.22","2994019","6396854365"
"418170","�ϳ�����22ȣ����","1942","2090","148","7.62","2257104","4747057835"
"427950","�ϳ�����23ȣ����","2287","3240","953","41.67","10627572","29122271615"
"430230","�ϳ�����24ȣ����","1995","2220","225","11.28","3754166","7886523000"
"435620","�ϳ�����25ȣ����","9801","9450","-351","-3.58","1434528","13796584380"
"299030","�ϳ����","54100","68500","14400","26.62","65106905","5822733192900"
"067310","�ϳ�����ũ��","9290","29900","20610","221.85","578183883","13126529309040"
"372290","�ϳ��ӽ�Ʈ7ȣ����","2217","4700","2483","112.00","15351125","46761662995"
"166090","�ϳ���Ƽ������","32700","55400","22700","69.42","42103868","1918308491106"
"136480","�ϸ�","2715","4430","1715","63.17","685579101","2740098564430"
"003380","�ϸ�����","7650","7950","300","3.92","350794187","3373238861400"
"101670","���̵�θ�Ƭ","22900","8410","-14490","-63.28","437829786","10166306701800"
"365590","���̵�","803","1515","712","88.67","761650927","1296795688027"
"149980","���̷δ�","7838","9850","2012","25.67","100707362","924456404770"
"013030","���̷��ڸ���","20500","26550","6050","29.51","24730036","609703022100"
"126700","���̺����ý���","18200","19590","1390","7.64","58086149","1153334817160"
"106080","���̼Ҵ�","11780","7830","-3950","-33.53","26532505","232758116870"
"377400","������6ȣ����","2037","1974","-63","-3.09","5086690","10475044077"
"400840","������7ȣ����","2020","2085","65","3.22","2206243","4595029035"
"221840","�������װ�","2970","2760","-210","-7.07","19190762","65271006315"
"106190","��������","7272","9390","2118","29.13","3584839","48765932270"
"373200","����ũ�ڸ���","5340","7450","2110","39.51","327983893","2306658062540"
"066130","����","5170","5600","430","8.32","32916539","216902252280"
"004590","�ѱ�����","4250","3985","-265","-6.24","13166147","58881448250"
"039340","�ѱ�����TV","5650","6000","350","6.19","28760590","183466514550"
"034950","�ѱ������","69000","76500","7500","10.87","444542","33007732900"
"222980","�ѱ��Ƴ�Ƽ","4995","4295","-700","-14.01","55305994","312004335595"
"256840","�ѱ��񿣾�","4650","3830","-820","-17.63","169141832","674514587450"
"025550","�ѱ�����","4010","3815","-195","-4.86","47977022","201319353305"
"017890","�ѱ�����","9900","11720","1820","18.38","72067547","882139268130"
"080720","�ѱ����Ͽ�����","7150","5040","-2110","-29.51","15515826","104241620835"
"063570","�ѱ����ڱ���","4590","6250","1660","36.17","91479360","569759637825"
"041460","�ѱ���������","4745","4650","-95","-2.00","190272057","1070393874575"
"101680","�ѱ����б��","2880","2705","-175","-6.08","48949714","227941487225"
"039740","�ѱ���������","3425","3910","485","14.16","47356897","224213753865"
"053300","�ѱ���������","4875","5320","445","9.13","124566093","696727037050"
"025770","�ѱ��������","11400","9590","-1810","-15.88","87273235","1208388270210"
"436610","�ѱ���11ȣ����","1491","2080","589","39.50","10074280","22956480510"
"023760","�ѱ�ĳ��Ż","746","585","-161","-21.58","54969578","35836550904"
"054040","�ѱ���ǻ��","4100","5520","1420","34.63","36723926","197414433195"
"021650","�ѱ�ť��","2905","2825","-80","-2.75","8537308","26067868470"
"053590","�ѱ���ũ�����","401","334","-67","-16.71","1167486221","564156533628"
"032300","�ѱ��ĸ�","21400","24450","3050","14.25","40513016","914063743290"
"037230","�ѱ���Ű��","2400","2060","-340","-14.17","29790602","82829471211"
"030520","�ѱ۰���ǻ��","12300","14580","2280","18.54","81013338","1189408729730"
"052600","�ѳ�Ʈ","5050","5110","60","1.19","98648617","554054773035"
"256150","�ѵ�ũ����","7250","7510","260","3.59","16670825","144721255800"
"092460","�Ѷ�IMS","5790","6540","750","12.95","18753706","122887255530"
"047080","�Ѻ�����Ʈ","3040","3045","5","0.16","61894574","174890982900"
"066980","�Ѽ�ũ����","3595","1649","-1946","-54.13","86264571","268222854458"
"114810","�Ѽ־��̿���","6630","10260","3630","54.75","23137940","196465155890"
"070590","�Ѽ���Ƽť��","1650","1698","48","2.91","38795467","80932638616"
"226440","�Ѽ۳׿���","1530","1530","0","0.00","0","0"
"042520","�ѽ����̿��޵�","9840","14770","4930","50.10","36808675","740721342910"
"078350","�Ѿ������","12150","14890","2740","22.55","35391517","492030906780"
"045100","�Ѿ��̿���","14450","15590","1140","7.89","94933861","1762743645300"
"024740","���ϴ���","2510","2330","-180","-7.17","241789347","670263987555"
"005860","���ϻ��","4210","4435","225","5.34","902999695","5441068606020"
"123840","��������","470","448","-22","-4.68","326385802","170887337605"
"007770","����ȭ��","16150","16590","440","2.72","36533879","898712681560"
"079170","��â���","8780","8340","-440","-5.01","77191395","1073089525640"
"054920","��������","3300","3360","60","1.82","271799209","1363087632840"
"002680","��ž","1180","1239","59","5.00","329731288","592067253902"
"386580","��ȭ�÷�����2ȣ����","2060","2040","-20","-0.97","3007363","6386757165"
"430460","��ȭ�÷�����3ȣ����","2015","2080","65","3.23","3118681","6419947500"
"034810","�ؼ����","9900","8060","-1840","-18.59","10169904","96654710350"
"03481K","�ؼ����1��","12800","9090","-3710","-28.98","3764032","49726189660"
"076610","�ؼ���ƽ��","460","312","-148","-32.17","248645612","109457968033"
"059270","�ؼ�Ƽ�Ǿ�","5440","7340","1900","34.93","87432955","674171290640"
"220180","�ڵ����Ʈ","3020","3710","690","22.85","169137941","736428699665"
"900270","��ͱ׷�","436","223","-213","-48.85","780064283","255026370508"
"214180","�����̳뺣�̼�","12050","14750","2700","22.41","8259813","109289481100"
"234340","�������̳���","19300","28350","9050","46.89","7921130","175789948110"
"084990","�︯���̽�","10550","6070","-4480","-42.46","62304079","443682659128"
"170030","�������","6030","7150","1120","18.57","168255998","1404062618620"
"319400","���빫����","3035","3440","405","13.34","1001350630","4234859227040"
"048410","������̿�","27400","26200","-1200","-4.38","210964722","5906074080490"
"052260","������̿�����","13450","10120","-3330","-24.76","6937909","82662333670"
"041440","���뿡������","8220","6350","-1870","-22.75","129721450","1045655950530"
"039010","���뿡��ġƼ","6720","5700","-1020","-15.18","33965593","275294170470"
"090850","����������","6830","5920","-910","-13.32","24259526","164411322930"
"092300","������","4400","4525","125","2.84","128038041","680164440910"
"138360","����","2240","1075","-1165","-52.01","247654923","394243441489"
"011080","����I&C","1200","940","-260","-21.67","92382368","110537550584"
"060560","Ȩ��ŸȦ����","1135","1214","79","6.96","213435387","279365757044"
"064240","Ȩĳ��Ʈ","4420","3095","-1325","-29.98","83649719","413769878849"
"039610","ȭ�����","4685","5510","825","17.61","61887792","379718877540"
"126640","ȭ������","1465","1711","246","16.79","70367004","130859532865"
"061250","ȭ�Ͼ�ǰ","2780","2235","-545","-19.60","327682339","806806048222"
"097870","ȿ�����غ�","7780","7570","-210","-2.70","70433849","620960209500"
"290270","�޳׽ÿ�","4245","3910","-335","-7.89","19947405","95749434880"
"353190","�޷�","1160","1114","-46","-3.97","73376435","90764893863"
"192410","�޸���Ʈ����","778","434","-344","-44.22","178039164","107214748742"
"090710","�޸��κ�","1715","1390","-325","-18.95","1803352747","4308910921767"
"078590","�޸�������","1190","486","-704","-59.16","383318366","220644375421"
"205470","�޸��ý�","3736","1950","-1786","-47.81","1740502032","7086839411764"
"115160","�޸ƽ�","3300","3040","-260","-7.88","316241216","1248128421190"
"028080","�޸ƽ�Ȧ����","3340","4760","1420","42.51","181779605","1206965118490"
"200670","�޸޵�","27700","32350","4650","16.79","20078727","656711087550"
"065510","�޺���","10250","19480","9230","90.05","56388177","1020872629240"
"215090","�޼���","1505","1505","0","0.00","0","0"
"263920","�޿��ؾ�","992","1134","142","14.31","110738371","151174226417"
"243070","�޿½�","29150","38100","8950","30.70","14420445","551128410850"
"084110","�޿½��۷ι�","18750","23000","4250","22.67","6169679","136034792178"
"145020","����","134900","152800","17900","13.27","18038694","2299528466454"
"024060","�ﱸ����","5680","7870","2190","38.56","459865083","4914189748825"
"010240","�ﱹ","5600","5870","270","4.82","11277521","72028578300"
"189980","�ﱹ��������","2670","2020","-650","-24.34","51762261","143927981787"
"037440","��","8200","7710","-490","-5.98","321700514","3076810040200"
"238490","����","6060","7010","950","15.68","40265994","322440609670"